absolute value => کری گرانی
all => همه
any => هیچ
ascii => ascii
binary => دوهزاری
boolean => بولین
byte array => آرایه‌ی بایت
bytes => بایت‌ها
callable => قابل فراخوانی
character => حرف
class method => métodê kelasê
compile => kompîl
complex => komplîks
delete attribute => atributê jêbirin
dictionary => ferheng
directory => dîrêktore
divide modulus => modulê bûna
enumerate => numre bikin
evaluate => bicîh bikin
execute => bikar bînin
filter => فیلتر
floating point => نقطہ لرزون
format => فارمات
frozen set => سیٹ جمع
get attribute => صفات کو لے لو
globals => گلوبلز
has attribute => صفات کے ہونے
hash => ہیش
help => مدد
hexadecimal => شیکسادشنال
identity => هەستی
input => وردەکاری
integer => ژمارەیی
is instance => هەیە کۆکراوە
is subclass => هەیە زیادکاری
iterator => فراوانکار
length => درێژی
list => لیست
locals => مۆڵەتیان
map => ناوبەری
maximum => زۆرترین
memory view => دیدەی حەیا
minimum => زۆرترین
next => دواتر
object => ئاسایش
octal => ئۆکتال
open => بکەوە
ordinal => سەرجەمی
power => قووت
print => چاپ
property => خاسیت
range => دۆزه‌ره‌وه‌
represent => نیشاندان
reversed => پێچوون
round => گۆران
set => دانان
set attribute => دانانی خاسیت
slice => بڕین
sorted => دەستهێڵ
staticymethod => شێوازی ئاسایی
string => نووسە
summation => بەشداری
superset => سوپەرسێت
tuple => تووپل
type => جۆر
variables => گۆڕانکاری
zip => ژیپ
capitalize => ناوی گه‌وڕێنە
case fold => ناوی کۆمەڵ
center => ناوخۆ
count => شمارش
encode => راستنووسی
ends with => با پایان دهە
expand tabs => پێکهاتەکان گەورەکردن
find => گەڕان
format map => ناوبری فۆرمات
index => بنچینە
is alphanumeric => الفانومریکە
is alphabetic => ئەلفابیتیکە
is ascii => ئەسسی
is decimal => کۆدی دێکێمالی
is digit => کۆدێک نرخی
is identifier => هەژمارێکی ناساندن
is lower => نووسینی بچووک
is numeric => نرخی
is printable => پێشکەوتنی
is space => فاصلە
is title => سەردێڕ
is uppercase => نووسینی گەورە
join => چوون
left justify => ستوونشتی کردن چپ
lower => لوور
left strip => لێدانی چپ
make translation => دروستکردنی وەرگێڕان
partition => پارتیشن
replace => گواستنەوە
reverse find => گەڕانی بگەڕش
reverse index => نمایشگری بگەڕش
right justify => ستوونشتی کردن ڕاست
right partition => پارتیشنی ڕاست
right split => ده‌یانه‌وه‌ی ڕاست
right strip => سڕینه‌وه‌ی ڕاست
split => ده‌یانکردن
split lines => ده‌یانه‌وه‌ی لێده‌ره‌كان
starts with => ده‌ستپێکردن به‌
strip => سڕینه‌وه‌
swap case => دووجار بگوازه‌وه‌ی كات
title => سه‌ردێڕ
translate => به‌شداری
uppercase => به‌شی بچووك
zero fill => شمەختی نێوانەشە
append => زیادکردن
clear => پاککردن
copy => کۆپیکردنەوە
extend => گەورەکردن
insert => داخستن
pop => نەشرکردن
remove => لابردن
reverse => پێڕستکردن
sort => هێنان
from keys => د كلیدونه
get => لیدنه
items => توکی
keys => كلیدونه
pop item => توکی بریدنه
set default => د پیش فرض نشون دادنه
update => اوسمهالول
values => ارزشونه
add => زیاتول
difference => فرق
difference update => نوسینی بدلش کردن
discard => ناخواسته بوون
intersection => نزدیکی
intersection update => نزدیکی بدلش کردن
is disjoint => نابەشکراوە
is subset => زۆرکەی
is superset => زۆرکەی زۆرتر
symmetric difference => نوسینی نیشانە
symmetric difference update => نوسینی نیشانە بدلش کردن
union => یەکگرتن
بند کردن
جدا کردن
نمبری په فایل
پاک کردن
چی کاری؟؟؟؟؟؟؟؟؟؟؟؟؟؟؟؟؟؟؟؟؟؟؟؟؟
خوندن
قابل خوندن
خوندنی لین
خوندنیان لین
پیدا کردن
seekable => پێکدەخۆشێت
tell => بنێ
truncate => کورتکردنەوە
writable => نووسینەوە
write => نووسین
write lines => نووسینی ڕێکخستنەکان
and => و
as => كە
assert => داواكردن
break => پارێزگەشتن
جوړونه
چاره ورکول
تعریفول
ړنګول
دغه وخت
دغه که
بیش له
ناسم
نه
په نه
from => له‌
global => گونجاو
if => گه‌ر
import => وارده‌کردن
in => له‌
is => هه‌یه‌
lambda => له‌مبا
none => هیچ
non-local => نه‌گونجاو
not => نه‌
or => یا
pass => پاس
raise exception => بیرون بخشیدنی بێجوون
return => گەڕانەوە
true => درووست
try => تاقی بکە
while => دوواە
with => بەهەمەشی
yield => بەردەوام بکە
arithmetic error => هەڵەی ئارێزی
error de aserción => خطای نێوانزەیی
خطای وێنە => خطای وێنە
ئەنجام => ئەنجام
خطای پایانی پەڕگە => خطای پایانی پەڕگە
خطای ناوەڕاستی پیت => خطای ناوەڕاستی پیت
خروجی ژمارەکار => خروجی ژمارەکار
خطای لێدان => خطای لێدان
خطای نێوانزە => خطای نێوانزە
خطای ناسینە => خطای ناسینە
خطای سەرچاوە => خطای سەرچاوە
interrupción del teclado => ناس نێوانی تێکست
شکایتی گەڕان => شکایتی گەڕان
شکایتی بۆشایی => شکایتی بۆشایی
شکایتی ناو => شکایتی ناو
ناتوانی داواکراو => ناتوانی داواکراو
شکایتی سیستەمی ئۆپێراتۆر => شکایتی سیستەمی ئۆپێراتۆر
شکایتی لەبەرزکردن => شکایتی لەبەرزکردن
شکایتی پێناسە => شکایتی پێناسە
شکایتی کۆدان => شکایتی کۆدان
شکایتی چوونەژوورەوە => شکایتی چوونەژوورەوە
syntax error => شکستی سینتاکسی
tab error => شکستی تب
system error => شکستی سیستم
system exit => خروجی سیستم
type error => شکستی جۆر
unbound local error => شکستی کورتی نەگرتوو
unicode error => شکستی یونیکۆد
unicode encode error => شکستی کۆدکردنی یونیکۆد
unicode decode error => شکستی دیکۆدکردنی یونیکۆد
unicode translate error => شکستی وەرگرتنی یونیکۆد
value error => شکستی نرخ
zero division error => شکستی بەشکردنی بەش
