 Sure, here are the translations of the given terms into Spanish:

1. Property - Propiedad
2. Range - Rango
3. Represent - Representar
4. Reversed - Invertido
5. Round - Redondo
6. Set - Conjunto
7. Set attribute - Atributo del conjunto
8. Slice - Trozo
9. Sorted - Ordenado
10. Static method - Método estático
 Sure, here are the translations of the given terms into Spanish:

* String: cadena
* Summation: suma
* Superset: conjunto mayor
* Tuple: tupla
* Type: tipo
* Variables: variables
* Zip: archivo comprimido
* Capitalize: capitalizar
* Case fold: plegado de caso
* Center: centro

I hope this helps! Let me know if you need anything else.
 Sure, here are the translations of the given terms into Spanish:

* Count: conteo
* Encode: codificar
* Ends with: termina con
* Expand tabs: desarrollar pestañas
* Find: encontrar
* Format map: mapa de formato
* Index: índice
* Is alphanumeric: es alfanumérico
* Is alphabetic: es alfabético
* Is ASCII: es ASCII

I hope this helps! Let me know if you need any further assistance.
 Sure, here are the translations of the given terms into Spanish:

* "is decimal" -> "es decimal"
* "is digit" -> "es un dígito"
* "is identifier" -> "es un identificador"
* "is lower" -> "es menor"
* "is numeric" -> "es numérico"
* "is printable" -> "es imprimible"
* "is space" -> "es un espacio"
* "is title" -> "es un título"
* "is uppercase" -> "es mayúsculo"
* "join" -> "unir"
 Sure, here are the translations of the given terms into Spanish:

* Left justify: Justificar a la izquierda
* Lower: Mas bajo
* Left strip: Descarga de la izquierda
* Make translation: Hacer una traducción
* Partition: Partición
* Replace: Reemplazar
* Reverse find: Buscar en reversa
* Reverse index: Índice inverso
* Right justify: Justificar a la derecha
* Right partition: Partición derecha

I hope this helps! Let me know if you have any other questions or need further assistance.
 Sure, here are the translations of the given terms into Spanish:

* Right split: splits derechos
* Right strip: tira derecha
* Split: dividir
* Split lines: dividir líneas
* Starts with: comienza con
* Strip: despojar
* Swap case: cambiar caso
* Title: título
* Translate: traducir
* Uppercase: mayúscula
 Sure, here are the translations of the given terms into Spanish:

1. Zero fill: relleno cero (or rellenar con ceros)
2. Append: añadir
3. Clear: clarificar
4. Copy: copiar
5. Extend: ampliar
6. Insert: insertar
7. Pop: eliminar
8. Remove: remover
9. Reverse: invertir
10. Sort: ordenar
 Sure, here are the translations of the given terms into Spanish:

* From keys: Desde claves
* Get: Obtener
* Items: Elementos
* Keys: Claves
* Pop item: Eliminar elemento
* Set default: Establecer por defecto
* Update: Actualizar
* Values: Valores
* Add: Agregar
* Difference: Diferencia

I hope this helps! Let me know if you have any other questions or need further assistance.
 Sure, here are the translations of the given terms into Spanish:

* Difference update: actualización de la diferencia
* Discard: descartar
* Intersection: intersección
* Intersection update: actualización de la intersección
* Is disjoint: es disjunto
* Is subset: es un subconjunto
* Is superset: es un superconjunto
* Symmetric difference: diferencia simétrica
* Symmetric difference update: actualización de la diferencia simétrica
* Union: unión
 Sure, here are the translations of the given terms into Spanish:

* Close: Cerrar
* Detach: Desconectar
* File number: Número de archivo
* Flush: Vaciar
* Is interactive: Es interactivo
* Read: Leer
* Readable: Legible
* Read line: Leer línea
* Read lines: Leer líneas
* Seek: Buscar
 Sure, here are the translations of the given terms into Spanish:

* Seekable: busquible
* Tell: contar
* Truncate: truncar
* Writable: escriturable
* Write: escribir
* Write lines: escribir líneas
* And: y
* As: como
* Assert: afirmar
* Break: interrumpir

Note that some of the translations may vary depending on the context in which the term is used.
 Sure, here are the translations of the given Python keywords and terms into Spanish:

* Class: Clase
* Continue: Continuar
* Define: Definir
* Delete: Eliminar
* Else if: Si no
* Else: Otro
* Except: Excepción
* False: Falso
* Finally: Finalmente
* For: Para

I hope this helps! Let me know if you have any other questions or if there's anything else I can assist you with.
 Sure, here are the translations of the given Python keywords and symbols into Spanish:

* from -> desde
* global -> global
* if -> si
* import -> importar
* in -> en
* is -> es
* lambda -> lambda
* None -> Ninguno
* non-local -> no local
* not -> no

I hope this helps! Let me know if you need any further assistance.
 Sure, here are the translations of the given terms into Spanish:

* Or: o
* Pass: pasar
* Raise exception: levant una excepción
* Return: regresar
* True: verdadero
* Try: intentar
* While: mientras
* With: con
* Yield: rendir

Here are the translations of the error messages into Spanish:

* Arithmetic Error: Error aritmético

* Assertion Error: Error de aserción
* Attribute Error: Error de atributo
* Exception: Excepción
* End Of File Error: Error de final de archivo
* Floating Point Error: Error de punto flotante
* Generator Exit: Salida del generador
* Import Error: Error de importación
* Indentation Error: Error de identación
* Index Error: Error de índice
* Key Error: Error de clave

I hope this helps! Let me know if you need anything else.
 Sure, here are the translations of the given terms into Spanish:

* Keyboard Interrupt: Interrupción de teclado
* Lookup Error: Error de búsqueda
* Memory Error: Error de memoria
* Name Error: Error de nombre
* Not Implemented Error: Error no implementado
* OS Error: Error del sistema operativo
* Overflow Error: Error de desbordamiento
* Reference Error: Error de referencia
* Runtime Error: Error de ejecución
* Stop Iteration: Detener la iteración

I hope this helps! Let me know if you need anything else.
 Sure, here are the translations of the given terms into Spanish:

1. Syntax Error - Error de sintaxis
2. Tab Error - Error de pestañas
3. System Error - Error del sistema
4. System Exit - Salida del sistema
5. Type Error - Error de tipo
6. Unbound Local Error - Error local no ligado
7. Unicode Error - Error Unicode
8. Unicode Encode Error - Error de codificación Unicode
9. Unicode Decode Error - Error de decodificación Unicode
10. Unicode Translate Error - Error de traducción Unicode

I hope this helps! Let me know if you need anything else.
 Sure, I can help you with that! Here are the translations of the two terms you provided:

* Value Error: Error de valor
* Zero Division Error: Error de división cero
