 Sure, here are the translations of the given Python terms into French:

* absolute value: valeur absolue
* all: tout
* any: cualquier
* ascii: ASCII
* binary: binaire
* boolean: booleen
* byte array: tableau de bytes
* bytes: octets
* callable: appelable
* character: caractère
* class method: méthode de classe
* compile: compiler
* complex: complexe
* delete attribute: supprimer attribut
* dictionary: dictionnaire
* directory: répertoire
* divide modulus: diviser le module
* enumerate: énumérer
* evaluate: évaluer
* execute: exécuter
* filter: filtrer
* floating point: punto flotante
* format: formatage
* frozen set: ensemble inmutable
* get attribute: obtenir attribut
* globals: globaux
* has attribute: a un attribut
* hash: hachage
* help: aide
* hexadecimal: hexadécimal
* identity: identité
* input: entrée
* integer: entier
* is instance: est-ce une instance
* is subclass: est-ce une sous-classe
* iterator: itérateur
* length: longueur
* list: liste
* locals: locaux
* map: mapa
* maximum: maximum
* memory view: vue de la mémoire
* minimum: minimum
* next: prochain
* object: objet
* octal: octal
* open: ouvert
* ordinal: ordinal
* power: puissance
* print: imprimante
* property: propriété
* range: plage
* represent: représenter
* reversed: retourné
* round: arrondi
* set: ensemble
* set attribute: définir attribut
* slice: rebanada
* sorted: trier
* static method: méthode statique
* string: chaîne
* summation: somme
* superset: sur-ensemble
* tuple: tupla
* type: type
* variables: variables
* zip: cremallera

I hope this helps! Let me know if you have any other questions.
 Sure, here are the translations of the given Python terms into French:

* Class method: méthode de classe
* Compile: compiler
* Complex: complexe
* Delete attribute: supprimer attribut
* Dictionary: dictionnaire
* Directory: répertoire
* Divide modulus: diviser le module
* Enumerate:énumérer
* Evaluate: évaluer
* Execute: exécuter

I hope this helps! Let me know if you have any other questions.
 Sure! Here are the translations of the given Python terms into French:

* Filter = filtrer
* Floating point = punto flotante
* Format = formato
* Frozen set = conjunto inmutable
* Get attribute = obtener atributo
* Globals = globales
* Has attribute = tiene atributo
* Hash = dispersión
* Help = ayuda
* Hexadecimal = hexadecimal

I hope this helps! Let me know if you have any other questions.
 Sure, here are the translations of the given Python terms into French:

* Identity: identité
* Input: entrée
* Integer: entier
* Is instance: est une instance
* Is subclass: est une sous-classe
* Iterator: iterateur
* Length: longueur
* List: liste
* Locals: locaux
* Map: carte

I hope this helps! Let me know if you have any other questions.
 Sure, here are the translations of the given terms into French:

* Maximum: maximum
* Memory view: vue de la mémoire
* Minimum: minimum
* Next: prochain
* Object: objet
* Octal: octal
* Open: ouvert
* Ordinal: ordinal
* Power: puissance
* Print: imprimir

I hope this helps! Let me know if you have any other questions.
 Sure, here are the translations of the given Python terms into French:

* Property: propriété
* Range: plage
* Represent: représenter
* Reversed: inversé
* Round: arrondi
* Set: ensemble
* Set attribute: attribut de l'ensemble
* Slice: tranches
* Sorted: trier
* Static method: méthode statique
 Sure, here are the translations of the given terms into French:

* String: chaîne
* Summation: somme
* Superset: ensemble contenant
* Tuple: tupla
* Type: type
* Variables: variables
* Zip: archive
* Capitalize: capitaliser
* Case fold: minuscule
* Center: centrer

I hope this helps! Let me know if you have any other questions.
 Here are the translations of the given Python terms into French:

1. count - compter
2. encode - encoder
3. ends with - se termine par
4. expand tabs - élargir les onglets
5. find - trouver
6. format map - carte de formatage
7. index - indice
8. is alphanumeric - est-alphanumérique
9. is alphabetic - est-alphabetique
10. is ascii - est-ASCII

Note that some of the terms may have multiple possible translations depending on the context and the level of technicality desired. These translations are provided as a general reference and may need to be adjusted based on the specific needs of your project.
 Sure, here are the translations of the given terms into French:

* "is decimal" -> "est décimal"
* "is digit" -> "est un chiffre"
* "is identifier" -> "est un identificateur"
* "is lower" -> "est en minuscule"
* "is numeric" -> "est numérique"
* "is printable" -> "est imprimable"
* "is space" -> "est un espace"
* "is title" -> "est un titre"
* "is uppercase" -> "est en majuscule"
* "join" -> "fusionner"

I hope this helps! Let me know if you have any other questions.
 Sure, here are the translations of the given terms into French:

* Left justify: Justifier à gauche
* Lower: Mettre en basse case
* Left strip: Retirer la partie gauche
* Make translation: Faire une traduction
* Partition: Partitionner
* Replace: Remplacer
* Reverse find: Trouver en sens inverse
* Reverse index: Index inversé
* Right justify: Justifier à droite
* Right partition: Partitionner à droite

I hope this helps! Let me know if you have any other questions.
 Sure, here are the translations of the given terms into French:

* Right split: partition droite
* Right strip: remise droite
* Split: partition
* Split lines: separer les lignes
* Starts with: commence avec
* Strip: remettre
* Swap case: intervertir le cas
* Title: titre
* Translate: traduire
* Uppercase: majuscule
 Sure, here are the translations of the given terms into French:

1. Zero fill: Remplir avec zéro
2. Append: Ajouter
3. Clear: Effacer
4. Copy: Copier
5. Extend: Étendre
6. Insert: Insérer
7. Pop: Retirer
8. Remove: Enlever
9. Reverse: Inverser
10. Sort: Trieler
 Sure, here are the translations of the given terms into French:

* From keys: "Des clés"
* Get: "Obtenir"
* Items: "Éléments"
* Keys: "Clés"
* Pop item: "Retirer un élément"
* Set default: "Définir par défaut"
* Update: "Mettre à jour"
* Values: "Valeurs"
* Add: "Ajouter"
* Difference: "Différence"

I hope this helps! Let me know if you have any other questions.
 Sure, here are the translations of the given terms into French:

* Difference update: Mise à jour de la différence
* Discard: Élimination
* Intersection: Intersection
* Intersection update: Mise à jour de l'intersection
* Is disjoint: Est disjoint
* Is subset: Est un sous-ensemble
* Is superset: Est un ensemble qui contient
* Symmetric difference: Différence symétrique
* Symmetric difference update: Mise à jour de la différence symétrique
* Union: Réunion
 Sure, here are the translations of the given Python terms into French:

* Close: Fermer
* Detach: Séparer
* File number: Numéro de fichier
* Flush: Vider
* Is interactive: Est interactif
* Read: Lire
* Readable: Lecturable
* Read line: Lire une ligne
* Read lines: Lire plusieurs lignes
* Seek: Rechercher

I hope this helps! Let me know if you have any other questions.
 Sure, here are the translations of the given terms into French:

* Seekable: rechercheable
* Tell: raconter
* Truncate: tronquer
* Writable: writable
* Write: écrire
* Write lines: écrire des lignes
* And: et
* As: comme
* Assert: affirmer
* Break: rompre

I hope this helps! Let me know if you have any other questions.
 Sure, here are the translations of the given Python keywords and phrases into French:

* Class: Classe
* Continue: Continuer
* Define: Définir
* Delete: Supprimer
* Else if: Si...sinon
* Else: Sinon
* Except: Sauf
* False: Faux
* Finally: Enfin
* For: Pour

I hope this helps! Let me know if you have any other questions.
 Sure, here are the translations of the given Python keywords into French:

* from -> de
* global -> global
* if -> si
* import -> importer
* in -> dans
* is -> est
* lambda -> lambda
* None -> None
* non-local -> non-local
* not -> ne ... pas

I hope this helps! Let me know if you have any other questions.
 Sure! Here are the translations of the given terms into French:

* Or: Ou
* Pass: Passer
* Raise exception: Levée d'exception
* Return: Retourner
* True: Vrai
* Try: Essayer
* While: Tandis que
* With: Avec
* Yield: Céder

Here are the translations of the given terms into French, with some additional explanations for certain terms:

* Arithmetic Error: Erreur arithmétique (This term refers to an error that occurs when there is a mistake in arithmetic operations such as addition, subtraction, multiplication, or division.)

I hope this helps! Let me know if you have any other questions.
 Sure, here are the translations of the given terms into French:

* Assertion Error: Erreur d'assertion
* Attribute Error: Erreur d'attribut
* Exception: Exception
* End Of File Error: Erreur de fin de fichier
* Floating Point Error: Erreur de punto flotante
* Generator Exit: Sortie du générateur
* Import Error: Erreur d'importation
* Indentation Error: Erreur de mise en page
* Index Error: Erreur d'indexation
* Key Error: Erreur de clé

I hope this helps! Let me know if you have any other questions.
 Sure, here are the translations of the given Python keywords and terms into French:

* Keyboard Interrupt: Interruption du clavier
* Lookup Error: Erreur de recherche
* Memory Error: Erreur de mémoire
* Name Error: Erreur de nom
* Not Implemented Error: Erreur de non-implémentation
* OS Error: Erreur du système d'exploitation
* Overflow Error: Erreur de débordement
* Reference Error: Erreur de référence
* Runtime Error: Erreur de temps d'exécution
* Stop Iteration: Arrêt de l'itération

I hope that helps!
 Sure, here are the translations of the given terms into French:

* Syntax Error: Erreur de syntaxe
* Tab Error: Erreur de tabulation
* System Error: Erreur système
* System Exit: Départ systématique
* Type Error: Erreur de type
* Unbound Local Error: Erreur locale non liée
* Unicode Error: Erreur Unicode
* Unicode Encode Error: Erreur d'encodage Unicode
* Unicode Decode Error: Erreur de décodage Unicode
* Unicode Translate Error: Erreur de translation Unicode

I hope this helps! Let me know if you have any other questions.
 Sure, here are the translations of the given terms into French:

* Value Error: Erreur de valeur
* Zero Division Error: Erreur de division par zéro
