 Sure, here are the translations of the given terms into French:

1. Absolute value - Valeur absolue
2. All - Tous
3. Any - N'importe quel
4. ASCII - ASCII
5. Binary - Binaire
6. Boolean - Booléen
7. Byte array - Tableau de bytes
8. Bytes - Octets
9. Callable - Appelable
10. Character - Caractère
 Sure, here are the translations of the given terms into French:

1. Class method: méthode de classe
2. Compile: compiler
3. Complex: complexe
4. Delete attribute: supprimer attribut
5. Dictionary: dictionnaire
6. Directory: répertoire
7. Divide modulus: diviser modulo
8. Enumerate: énumérer
9. Evaluate: évaluer
10. Execute: exécuter
 Sure, here are the translations for the given terms into French:

* Filter - Filtre
* Floating point - Nombre à virgule flottante
* Format - Formatage
* Frozen set - Ensemble figé
* Get attribute - Attribut get
* Globals - Variables globales
* Has attribute - A une propriété
* Hash - Haash
* Help - Aide
* Hexadecimal - Hexadécimal
 Sure, here are the translations of the given terms into French:

1. Identity - Identité
2. Input - Entrée
3. Integer - Entier
4. Is instance - Est-ce qu'il s'agit d'une instance?
5. Is subclass - Sous-classe
6. Iterator - Itérateur
7. Length - Longueur
8. List - Liste
9. Locals - Locaux
10. Map - Carte
 Sure, here are the translations of the given terms into French:

1. Maximum - Maximun
2. Memory View - Vue de la mémoire
3. Minimum - Minimum
4. Next - Suivant
5. Object - Objet
6. Octal - Octal
7. Open - Ouvert
8. Ordinal - Ordinale
9. Power - Puissance
10. Print - Impression
 Sure, here are the translations of the given terms into French:

1. Property - propriété
2. Range - plage
3. Represent - représenter
4. Reversed - inverse
5. Round - arrondi
6. Set - ensemble
7. Set attribute - attribut de l'ensemble
8. Slice - trananche
9. Sorted - trié
10. Static method - méthode statique
 Sure, here are the translations of the given terms into French:

1. String - Chaîne
2. Summation - Sommation
3. Superset - Ensemble contenant
4. Tuple - Tupla
5. Type - Type
6. Variables - Variables
7. Zip - Zippé
8. Capitalize - Capitaliser
9. Case fold - Folding en majuscule
10. Center - Centre
 Sure, here are the translations of the given terms into French:

1. Count - Compter
2. Encode - Coder
3. Ends with - Se termine par
4. Expand tabs - Élargir les onglets
5. Find - Trouver
6. Format map - Carte de formatage
7. Index - Index
8. Is alphanumeric - Est-ce que c'est alphanumérique?
9. Is alphabetic - Est-ce que c'est alphabétique?
10. Is ASCII - Est-ce que c'est en ASCII ?
 Sure, here are the translations of the given terms into French:

* "is decimal" = "est décimal"
* "is digit" = "est un chiffre"
* "is identifier" = "est un identificateur"
* "is lower" = "est en bas"
* "is numeric" = "est numérique"
* "is printable" = "est imprimable"
* "is space" = "est une espace"
* "is title" = "est un titre"
* "is uppercase" = "est en majuscule"
* "join" = "fusionner"
 Sure, here are the translations of the given terms into French:

1. Left justify: Justifier à gauche
2. Lower: Diminué
3. Left strip: Effacer à gauche
4. Make translation: Faire une traduction
5. Partition: Partitionner
6. Replace: Remplacer
7. Reverse find: Trouver en sens inverse
8. Reverse index: Index inverse
9. Right justify: Justifier à droite
10. Right partition: Partitionner à droite
 Sure, here are the translations of the given terms into French:

* Right split: "Fractionnement à droite" (literally "right fractioning")
* Right strip: "Bandeau à droite" (literally "right strip")
* Split: "Fractionner" (to split)
* Split lines: "Lignes de fractionnement" (lines for splitting)
* Starts with: "Commence avec" (literally "starts with")
* Strip: "Bandeau" (strip)
* Swap case: "Inverser les cases" (to invert the cases)
* Title: "Titre" (title)
* Translate: "Traduire" (to translate)
* Uppercase: "Majuscule" (uppercase)
 Sure, here are the translations of the given terms into French:

1. Zero fill: remplir avec zéro
2. Append: ajouter
3. Clear: effacer
4. Copy: copier
5. Extend: étendre
6. Insert: insérer
7. Pop: retirer
8. Remove: enlever
9. Reverse: inverser
10. Sort: trier
 Sure, here are the translations of the given terms into French:

1. "keys" - "clés"
2. "get" - "obtenir"
3. "items" - "articles"
4. "keys" - "clés" (yes, it's the same word)
5. "pop item" - "retirer un article"
6. "set default" - "définir par défaut"
7. "update" - "mettre à jour"
8. "values" - "valeurs"
9. "add" - "ajouter"
10. "difference" - "différence"
 Sure, here are the translations of the given terms into French:

* Difference update: mise à jour de la différence
* Discard: élimination
* Intersection: intersection
* Intersection update: mise à jour de l'intersection
* Is disjoint: est disjoint
* Is subset: est un sous-ensemble
* Is superset: est un ensemble contenant tous les éléments d'un autre ensemble
* Symmetric difference: différence symétrique
* Symmetric difference update: mise à jour de la différence symétrique
* Union: union
 Sure, here are the translations of the given terms into French:

1. Close - Fermer
2. Detach - Détacher
3. File number - Numéro de fichier
4. Flush - Évacuer
5. Is interactive - Est interactif
6. Read - Lire
7. Readable - Lecturable
8. Read line - Lire une ligne
9. Read lines - Lire des lignes
10. Seek - Rechercher
 Sure, here are the translations of the given terms into French:

1. Seekable - Accessible
2. Tell - Raconter
3. Truncate - Tronquer
4. Writable - Écrire
5. Write - Écrire
6. Write lines - Écrire des lignes
7. And - Et
8. As - Comme
9. Assert - Affirmer
10. Break - Casser
 Sure, here are the translations of the given terms into French:

1. Class - Classe
2. Continue - Continuer
3. Define - Définir
4. Delete - Supprimer
5. Else if - Sinon si
6. Else - Sinon
7. Except - Sauf
8. False - Faux
9. Finally - Enfin
10. For - Pour
 Sure, here are the translations of the given terms into French:

* from = de (pronounced "deh")
* global = global (pronounced "globe-al")
* if = si (pronounced "see")
* import = importer (pronounced "im-pohr-tey")
* in = dans (pronounced "dahns")
* is = est (pronounced "ehst")
* lambda = lambda (pronounced "lahnda")
* None = none (pronounced "nohnee")
* non-local = non-local (pronounced "nohn-loh-kah")
* not = ne ... pas (pronounced "neh ... pahs")
 Sure, here are the translations of the given terms into French:

* Or: ou
* Pass: passer
* Raise exception: lever une exception
* Return: renvoyer
* True: vrai
* Try: essayer
* While: pendant
* With: avec
* Yield: rapporter
* Arithmetic Error: erreur arithmétique
 Sure, here are the translations for the given terms into French:

1. Assertion Error - Erreur d'assertion
2. Attribute Error - Erreur d'attribut
3. Exception - Exception
4. End Of File Error - Erreur de fin de fichier
5. Floating Point Error - Erreur de point flottant
6. Generator Exit - Fin de générateur
7. Import Error - Erreur d'importation
8. Indentation Error - Erreur de mise en forme
9. Index Error - Erreur d'indexation
10. Key Error - Erreur de clé

I hope this helps! Let me know if you have any further questions.
 Sure, here are the translations of the given terms into French:

1. Keyboard Interrupt - Interruption de clavier
2. Lookup Error - Erreur de recherche
3. Memory Error - Erreur de mémoire
4. Name Error - Erreur de nom
5. Not Implemented Error - Erreur non implémentée
6. OS Error - Erreur de système d'exploitation
7. Overflow Error - Erreur de débordement
8. Reference Error - Erreur de référence
9. Runtime Error - Erreur au moment de l'exécution
10. Stop Iteration - Arrêt de la boucle
 Sure, here are the translations of the given terms into French:

1. Syntax Error - Erreur de syntaxe
2. Tab Error - Erreur de tabulation
3. System Error - Erreur système
4. System Exit - Sortie du système
5. Type Error - Erreur de type
6. Unbound Local Error - Erreur de variable non liée
7. Unicode Error - Erreur Unicode
8. Unicode Encode Error - Erreur d'encodage Unicode
9. Unicode Decode Error - Erreur de décodage Unicode
10. Unicode Translate Error - Erreur de traduction Unicode
 Sure, I'd be happy to help! Here are the translations for "Value Error" and "Zero Division Error" in French:

* Value Error: Erreur de valeur
* Zero Division Error: Erreur de division par zéro
