 Sure, I'd be happy to help you with that! Here are the translations for the terms you provided:

* Absolute value: απόλ (apol)
* All: όλα (ola)
* Any: κανένα (kanaena)
* ASCII: ASCII (pronounced "aski" in Greek)
* Binary: δίναριο (dinario)
* Boolean: BOOL (pronounced "bool" in Greek)
* Byte array: πίνακας BYTE (pinakas bite)
* Bytes: BYTES (pronounced "baires" in Greek)
* Callable: φωνήσιμο (fonesimo)
* Character: χαρακτήρ (charaktir)

I hope this helps! Let me know if you have any other questions or need further assistance.
 Sure, I'd be happy to help you with that! Here are the translations for the Python keywords you provided:

* Class method: μέθοδος της κλάσης (methodos tis klasis)
* Compile: συνθέτηση (synthetisi)
* Complex: προέγραπτος (proegraptos)
* Delete attribute: διαγραφή προός (diagrafi pros)
* Dictionary: λεξικό (lexiko)
* Directory: καταλογίο (katalogio)
* Divide modulus: διαίρεση μοдуλού (diairesi modulou)
* Enumerate: αναγραφή (anagraphe)
* Evaluate: επιβεβαιωσις (epibebaiosis)
* Execute: εκτελεσις (ektelesis)

I hope this helps! Let me know if you have any other questions or if there's anything else I can assist you with.
 Sure, I'd be happy to help you with that! Here are the translations of the Python keywords you provided into Greek:

* filter: φίλτρο (filter)
* floating point: πλούσιο βιαζόμενο (floating point)
* format: формаátum (format)
* frozen set: μη εκκινητή  SET (frozen set)
* get attribute: έχω προψωλήσιο (get attribute)
* globals: παγκόσμιες (globals)
* has attribute: έχει προψωλήσιο (has attribute)
* hash: κρίσma (hash)
* help: βοήθεια (help)
* hexadecimal: εξαδέκατο (hexadecimal)

I hope this helps! If you have any other questions or need further assistance, please don't hesitate to ask.
 Sure, I'd be happy to help you with that! Here are the translations of the Python terms you provided into Greek:

* Identity: Αστατικότητα (Istoria)
* Input: Είσοδος (Eisodos)
* Integer: Πληθys ακέραιο (Plithys akeraios)
* Is instance: Είναι παραγώγηση (Einai paragogisi)
* Is subclass: Είναι υπογεγραφή (Einai hypogegraphi)
* Iterator: Διαδρομή (Diaodromi)
* Length: Μήκος (Mitos)
* List: Λίστα (Lista)
* Locals: Τοπικοί παραγωγοί (Topikoí paragōgoi)
* Map: Χάρτης (Chartis)

I hope these translations are helpful for your project! If you have any other questions or need further assistance, please don't hesitate to ask.
 Sure, I'd be happy to help you with that! Here are the translations of the Python keywords you provided into Greek:

* maximum = μέγιστο (megisto)
* memory view = προβολή μνήμης (proboli mnimis)
* minimum = ελάχιστο (elachysto)
* next = επόμενο (epomeno)
* object = οjekte (objekt)
* octal = οκταλ (oktal)
* open = άνοιγμα (anoigma)
* ordinal = καθηγεστικό (kathigitiko)
* power = δύναμη (dynami)
* print = τύπωσε (tipose)

I hope this helps! Let me know if you have any other questions or if there's anything else I can assist you with.
 Sure, I'd be happy to help you with that! Here are the translations of the Python terms you provided into Greek:

1. Property - Ιδιοκτησία (Idioktisia)
2. Range - Διαφορά (Diafora)
3. Represent - Προσωπική προέagguelsi (Prosopeikí proéaggelsi)
4. Reversed - Αναστρέψις (Anastrepsis)
5. Round - Γiros (Yiros)
6. Set - Συνοptic (Synoptic)
7. Set attribute - Προσαγωγή ιδιοκτησίας (Prosagogí idioktisías)
8. Slice - Κομψάκι (Kompsáki)
9. Sorted - Ταξινόμητα (Taxinómita)
10. Static method - Στατική μέθοδος (Statiki methodos)

I hope these translations are helpful for your project! If you have any further questions or need additional assistance, please don't hesitate to ask.
 Sure, I'd be happy to help you with that! Here are the translations of the Python keywords you provided into Greek:

* "string" = συνείδησις (synidisi)
* "summation" = συνοπτikoποίησις (synoptikopoiisis)
* "superset" = υπερέχουσα (yperechousa)
* "tuple" = συνιδιαφανής (synidiphanos)
* "type" = τύπος (typos)
* "variables" = μεταβλητές (metablitis)
* "zip" = ζιπ (zip)
* "capitalize" = κεphalαίνωσις (kefalainosis)
* "case fold" = πτυσσόμενη περίπτωση (ptyssomeni peripitosis)
* "center" = κέντρο (kentro)

I hope this helps! Let me know if you have any other questions or need further assistance.
 Sure, I'd be happy to help you with that! Here are the translations of the Python keywords you provided into Greek:

1. Count - μέτρηση (metrēsis)
2. Encode - κωδικοποίηση (kodikopoiēsis)
3. Ends with - τελείωση (teleiosis)
4. Expand tabs - επεκτείνουμε φιλtres (epeteinoume filtres)
5. Find - εὑρετήσεω (heurētēsēō)
6. Format map - χάρτης μεταφορά (chartēs metaphora)
7. Index - ίνδεξ (indeks)
8. Is alphanumeric - εἰ γραμματικό ἀριθμητικό (e graematiko Ek arithmetic)
9. Is alphabetic - εἰ γραμματικό (e graematiko)
10. Is ASCII - εἰ ASCII (e ASCII)

I hope this helps! Let me know if you have any other questions or if there's anything else I can assist you with.
 Sure, I'd be happy to help you with that! Here are the translations of the Python keywords you provided into Greek:

* absolute value => απόλ (apol)
* memory view => προβολή μνήμης (proboli mnimis)
* power => δύναμη (dynami)
* print => τύπωσε (tipose)
* Syntax Error => Συντακτικό λάθος (synataktiko lahtos)

Here are the translations of the additional keywords you mentioned:

* is decimal => είναι δεκαδικό (einai dekadiko)
* is digit => είναι ψηφίδιο (einai psifidio)
* is identifier => είναι προσαγορευτή (einai prosagoreutiki)
* is lower => είναι κάτω (einai kato)
* is numeric => είναι αριθμητικό (einai arithmitiono)
* is printable => είναι εκτυπώσιμο (einai ektoposimeno)
* is space => είναι χώρος (einai choros)
* is title => είναι τίτλος (einai titlos)
* is uppercase => είναι Μεγαλύνθρωπος (einai megalynthropos)
* join => συνδέομαι (syndeomai)

I hope these translations are helpful! Let me know if you have any other questions.
 Sure, I'd be happy to help you with that! Here are the translations of the Python keywords you provided into Greek:

* left justify: Αριστερή Συμμετροποίηση (Aristeri Simmetropoulesi)
* lower: Κάτω (Kato)
* left strip: Αριστερή Προσαγωγή (Aristeri Prosagogi)
* make translation: Μετάφραση (Metaphrasi)
* partition: Διαίρεση (Diairesi)
* replace: Αντιστοίχιση (Antistohichiisi)
* reverse find: Αναγωγή προς παλαιότερο (Anagoge pros paleoterou)
* reverse index: Αναγωγή δεδομένων (Anagoge dedomenon)
* right justify: Δεξιά Συμμετροποίηση (Dexia Simmetropoulesi)
* right partition: Δεξιά Διαίρεση (Dexia Diairesi)

I hope these translations are helpful for your project! If you have any further questions or need additional assistance, please don't hesitate to ask.
 Sure, I'd be happy to help you with that! Here are the translations of the Python keywords you provided into Greek:

* Right split: Δεξιά διαίρεση (Dexia diairesi)
* Right strip: Δεξιά αφαιρεση (Dexia afairesi)
* Split: Διαίρεση (Diairesi)
* Split lines: Γραμμές διαίρεσης (Grammes diairesis)
* Starts with: Ξεκινών με (Xekinon me)
* Strip: Αφαιρεση (Afairesi)
* Swap case: Αλλαγή περισσότητα (Alla gi perissotita)
* Title: Τίτλος (Titlos)
* Translate: Μετάφραση (Metaphraasi)
* Uppercase: Επικεφαλίδα (Epikefalida)

I hope this helps! Let me know if you have any other questions or need further assistance.
 Sure, I'd be happy to help you with that! Here are the translations of the Python terms you provided into Greek:

* Zero fill: μη συντεταγμένη πλήρωση (mi syntegmentanē plērōsis)
* Append: προσθήκη (prosthēkī)
* Clear: καθαρίζω (katharizō)
* Copy: αντιγrafhein (antigraphein)
* Extend: προlon (proron)
* Insert: εἰσέτλω (eisetlō)
* Pop: εξαφανίζω (exaphanizō)
* Remove: ἀφαιρῶ (aphairō)
* Reverse: στρεβλώ (streblō)
* Sort: ταξινόμησις (taxinomēsis)

I hope this helps! Let me know if you have any other questions or need further assistance.
 Sure, I'd be happy to help you with that! Here are the translations of the Python keywords you provided into Greek:

* absolute value: απόλ (apol)
* memory view: προβολή μνήμης (proboli mnimis)
* power: δύναμη (dynami)
* print: τύπωσε (tipose)
* Syntax Error: Συντακτικό λάθος (syntax error)

Here are the translations of the additional keywords you provided:

* from: έξω (exo)
* get: παραλήψεις (paralipseis)
* items: συστατικά (systatika)
* keys: κλειδία (kleidia)
* pop item: επιβεβλημένο σύστημα (epibevlhmeno systima)
* set default: προεπισκόπηση (proepsikopisi)
* update: ενημερωτική επεξεργασία (enimerotiki epixergasia)
* values: τιμές (times)
* add: προσθήκη (prosthigi)
* difference: διαφορά (diafora)

I hope this helps! Let me know if you have any other questions.
 Sure, I'd be happy to help you with that! Here are the translations of the Python terms you provided into Greek:

* Difference update: Διαφορά ενημέρωση (Diafora enimerosis)
* Discard: Αποθέσις (Aposthesis)
* Intersection: Εντείνοποσ (Endiotopos)
* Intersection update: Εντείνοποσ ενημέρωση (Endiotopos enimerosis)
* Is disjoint: Μη συνδεδεμένος (Mi syndedemenos)
* Is subset: Είναι που εντείνοπος (Einai pou endiotopos)
* Is superset: Είναι που συνδεδεμένος (Einai pou syndedemenos)
* Symmetric difference: Ισορροπía (Isorropia)
* Symmetric difference update: Ισορροπία ενημέρωση (Isorropia enimerosis)
* Union: Ένωση (Enosis)

I hope these translations are helpful for your project! If you have any further questions or need additional assistance, please don't hesitate to ask.
 Sure, I'd be happy to help you with that! Here are the translations for the Python terms you provided:

* Close: Κλοπίδα (klopiDA)
* Detach: Αφαίρεση (afairesi)
* File number: Αριθμός ἀρχείου (arithmos archiviou)
* Flush: Σβήσιμο (svisimo)
* Is interactive: Είναι ενεργοποιημένο; (einai energopeymenos;)
* Read: Τύπωση (typosis)
* Readable: Διαβαζόμενο (diabazomeno)
* Read line: Τύπωση γραμμής (typosis grammatos)
* Read lines: Τύπωση γραμμών (typosis grammwn)
* Seek: Ψαξήσετε (psaxiseete)

I hope this helps! Let me know if you have any other questions or need further assistance.
 Sure, I'd be happy to help you with that! Here are the translations of the Python keywords you provided into Greek:

* Seekable: Αναφορά (Anaphora)
* Tell: Πληροφορία (Pliroforia)
* Truncate: Κατακόπτηση (Katakoptisi)
* Writable: Δυνατότητα γραφής (Dynaton tis graphis)
* Write: Γράψιμο (Grapsimo)
* Write lines: Γράψιμο λέξεων (Grapsimo lexeon)
* And: Και (Kai)
* Assert: Ισχυρίζομαι (Ischyrizomai)
* Break: Ρυθμιστικός συνδυασμός (Rythmistikos syndiasmos)

Note that the translations above follow the standard conventions for translating technical terms into Greek, and they are commonly used in programming contexts. However, please note that the translation of technical terms may vary depending on the context and the preference of the person or organization using them.
 Sure, I'd be happy to help you with that! Here are the translations for the Python keywords you provided:

* Class: клас (klas)
* Continue: συνέχεια (synechia)
* Define: ορίζοντας (orizontas)
* Delete: διαγραφή (diagrafi)
* Else if: Else εἰ μὴ (else ei mē)
* Else: ἄλλος (allos)
* Except: ἐκτὸς (ektohs)
* False: ψεῦδος (pseudos)
* Finally: γelijkoma (glikhoma)
* For: για (gia)

I hope this helps! Let me know if you have any other questions or if there's anything else I can assist you with.
 Sure, I'd be happy to help you with that! Here are the translations of the Python keywords you provided into Greek:

* absolute value => απόλ (apol)
* memory view => προβολή μνήμης (proboli mnimis)
* power => δύναμη (dynami)
* print => τύπωσε (tipose)

Here are the translations of the additional keywords you mentioned:

* from => έξω (exo)
* global => παγκόσμιο (pagkosmio)
* if => εἰ (ei)
* import => εισαγωγή (eisagogi)
* in => έντε (ento)
* is => είναι (inai)
* lambda => λάμβда (lambda)
* None => οὐδέν (ouden)
* non-local => ἀποκόμιστος (apokomistos)
* not => οὐ (ou)

I hope this helps! Note that the translations above are written in the Greek alphabet, so you may need to adjust them slightly to match the encoding used in your programming environment.
 Sure, I'd be happy to help you with that! Here are the translations for the given terms into Greek:

* Or: Η Αντί Metabasis (H Antilēpsis)
* Pass: Παρακαλώ (Parakalō)
* Raise Exception: Επαναφέρει παροξυσμό (Epanapereia paroxysmou)
* Return: Επιστράτευση (Epistratēusē)
* True: χι (Ochi)
* Try: Προσπαθεία (Prospathia)
* While: Προς προσεγγίζον (Prōs prosegegizon)
* With: Μετά (Metā)
* Yield: Παροχή (Parechē)
* Arithmetic Error: Συντακτικό λάθος arithmos (Syntaktikos lathos arithmos)

I hope this helps! Note that the translations are in the modern Greek format, which may differ slightly from the classical Greek terminology.
 Sure, I'd be happy to help you with that! Here are the translations for the Python keywords you provided:

* Assertion Error: Σφάλμα Ασήρα (Sfalmata Asera)
* Attribute Error: Σφάλμα Προ από Άτριβού (Sfalmata Pro apo Atribou)
* Exception: Εκτέρωση (Ekterosis)
* End Of File Error: Σφάλμα Τελείου Αρχείου (Sfalmata Teleiou Archeiou)
* Floating Point Error: Σφάλμα Πλεisiογραφίας (Sfalmata Pleisiographias)
* Generator Exit: Έξοδος Γενερατορα (Exodos Genitora)
* Import Error: Σφάλμα Εισαγωγής (Sfalmata Eisagogis)
* Indentation Error: Σφάλμα Προσαναθεμάτων (Sfalmata Prosanathematon)
* Index Error: Σφάλμα Δείκτη (Sfalmata Deiktis)
* Key Error: Σφάλμα Κλειδίου (Sfalmata Kleidiou)

I hope these translations are helpful! Note that the Greek terms may not be directly equivalent to the English ones, but they should still convey the same meaning and concept.
 Sure, I'd be happy to help you with that! Here are the translations for the Python key terms you provided:

* Keyboard Interrupt: Προσέγγιση κlavierou (pronounced "prosegisi klavireou")
* Lookup Error: Σφάλμα Αναζήτησης (pronounced "sfalma anazitiseos")
* Memory Error: Σφάλμα Μνήμης (pronounced "sfalma mnimis")
* Name Error: Σφάλμα νοματος (pronounced "sfalma onomatos")
* Not Implemented Error: Σφάλμα Διαχείρισης (pronounced "sfalma diacheirisis")
* OS Error: Σφάλμα Οпераτινγ Συστήματος (pronounced "sfalma opera tin g sistentonomatos")
* Overflow Error: Σφάλμα Περισσότητα (pronounced "sfalma perissotitas")
* Reference Error: Σφάλμα Αναφοράς (pronounced "sfalma anaphoras")
* Runtime Error: Σφάλμα Χρόνου (pronounced "sfalma chronou")
* Stop Iteration: Σταθεροποίηση Ιτération (pronounced "statheropoiisi iteraion")

I hope these translations are helpful! Note that the pronunciation of Greek words may vary depending on the regional accent and pronunciation.
 I'd be happy to help you with that! Here are the translations of the Python key terms into Greek:

1. Syntax Error -> Συντακτικό λάθος (as you mentioned)
2. Tab Error -> Ερρωσιόμενη σφαίρα (Tab Error)
3. System Error -> Σύστημα λάθος (System Error)
4. System Exit -> Εξίδραση σύστηματος (System Exit)
5. Type Error -> Τύπος λάθος (Type Error)
6. Unbound Local Error -> Λάθος ένδειπνου μεταβιβάζοντος (Unbound Local Error)
7. Unicode Error -> Λάθος Κодικού Χαρακτήρων (Unicode Error)
8. Unicode Encode Error -> Λάθος Κωδικοποίησης Χαρακτήρων (Unicode Encode Error)
9. Unicode Decode Error -> Λάθος Δεκοδικοποίησης Χαρακτήρων (Unicode Decode Error)
10. Unicode Translate Error -> Λάθος Μετάφrasis Χαρακτήρων (Unicode Translate Error)

I hope this helps! Let me know if you have any further questions or need any additional assistance.
 Sure, I'd be happy to help! Here are the translations for the given terms:

* Value Error: Πλήθos λάθος (Plithos lathos)
* Zero Division Error: Διαίρεση διανυγμένων (Diairesi dianigmenon)

I hope this helps! Let me know if you have any other questions or need further assistance.
