 Sure, I'd be happy to help you with that! Here are the translations of the Python keywords you provided into Greek:

1. Absolute value: απολυτή μεγέθυση (apolutí megéthusis)
2. All: όλα (ola)
3. Any: κάποια (kápoia)
4. ASCII: ASCII (pronounced "aski" in Greek)
5. Binary: δυαδικός (dyadikos)
6. Boolean: ψηφίδωρος (psifidóros)
7. Byte array: πίνακας BYTE (pínakas BYTE)
8. Bytes: πίνακες (pínakes)
9. Callable: πρωτότυπος (prototipos)
10. Character: χαρακτήρ (charaktēr)

I hope this helps you with your project! If you have any further questions or need additional assistance, feel free to ask.
 Sure, I'd be happy to help you with that! Here are the translations of the Python keywords you provided into Greek:

1. Class method: τέχνη μέθοδος (technē methodos)
2. Compile: συναγείοπλήρωση (synageioplasis)
3. Complex: προσεικτικός (proseiktimos)
4. Delete attribute: διαμβακύνωση προσόντων (diamvakynōsyn prsontōn)
5. Dictionary: λεξικόν (lexikon)
6. Directory: καταλογός (katalogos)
7. Divide modulus: διαίρεση μοдуλού (diairesi modulou)
8. Enumerate: αρίθμηση (arithmīsī)
9. Evaluate: εκτιμητική προσέγγιση (ek timitikē prosegisi)
10. Execute: εκτιμητική διεκδίκηση (ek timitikē diadikēsē)

I hope these translations are helpful for your project!
 Sure, I'd be happy to help you with that! Here are the translations of the Python keywords you provided into Greek:

* filter: φίλτρο (filter)
* floating point: αναπαρεσκορικός προσδιορθωτής (ana pareskorikos pros diorthotis)
* format: μορφοποίηση (morphopoiisi)
* frozen set: συγκυρωτός σύνολος (sygkritos synolos)
* get attribute: βάση προσόντων (base prosontov)
* globals: παγκόσμιες (pagkosmias)
* has attribute: έχει βάση (echei base)
* hash: κρεμαστρό (kremastro)
* help: βοήθεια (boithia)
* hexadecimal: έξαδεκαδικός (exadekadikos)

I hope these translations are helpful for your project! If you have any further questions or need additional assistance, please don't hesitate to ask.
 Sure, I'd be happy to help you with that! Here are the translations of the Python key terms you provided into Greek:

* Identity: ταυτοποίηση (tautopoiisi)
* Input: εἰσόδιμος (eisodimos)
* Integer: ακέραιος (akeraios)
* Is instance: εἰ ἐστιν ἔνδειξη (e if estin endeixē)
* Is subclass: εἰ ἐστιν ὑποκλ (e if estin hypoklas)
* Iterator: διαφορική σχεδόν (diaphorikē schedon)
* Length: μήκος (mēkos)
* List: λίστα (listā)
* Locals: τοπικοί (topikoí)
* Map: χάρτης (chartēs)

I hope this helps! Let me know if you have any other questions or need further assistance.
 Sure, I'd be happy to help you with that! Here are the translations of the Python key terms you provided into Greek:

* maximum: μέγιστο (megisto)
* memory view: προβολή μνημείας (proboli mniemias)
* minimum: ελάχιστο (elachistro)
* next: επόμενο (epomeno)
* object: όβJECT (objekt)
* octal: οκταλ (oktal)
* open: ανοιχτό (anoichto)
* ordinal: ορδιναλ (ordinal)
* power: ίσχυρο (ischyro)
* print: εκτύπωση (ektypwsis)

I hope this helps! Let me know if you have any other questions or need further assistance.
 Sure, I'd be happy to help you with that! Here are the translations of the Python keywords you provided into Greek:

* Property: Ιδιωτικός (Idiotikos)
* Range: Διαγραμμα (Diagramma)
* Represent: Προσωπεία (Prosopeia)
* Reversed: Αναστρέφω (Anastrefo)
* Round: Συνολικός (Synolikos)
* Set: Ομάδα (Omalda)
* Set attribute: Ρυθμιστική ιδιωτικότητα (Rythmistiki Idiotikotita)
* Slice: Επιβολή (Epivoli)
* Sorted: Ταξινόμητος (Taxinomitos)
* Static method: Στατική μέθοδος (Statiki Metodos)

I hope this helps you with your project! If you have any other questions or need further assistance, feel free to ask.
 Sure, I'd be happy to help you with that! Here are the translations of the Python keywords you provided into Greek:

* String: Σtring (pronounced "stiring")
* Summation: Συναθροισμός (pronounced "sina-throis-mos")
* Superset: ΥπερεγγρΑτη (pronounced "ype-reggra-tee")
* Tuple: Ταπλ (pronounced "taple")
* Type: Τύπος (pronounced "typos")
* Variables: Εναλλακτικά (pronounced "enal-la-kti-ka")
* Zip: Ζίπ (pronounced "zip")
* Capitalize: Καπιταλιζειν (pronounced "kapi-ta-li-zein")
* Case fold: Πτυχή (pronounced "p-tou-chi")
* Center: Κέντρο (pronounced "ke-ntro")

I hope this helps you with your project! If you have any other questions or need further assistance, feel free to ask.
 I'd be happy to help you with that! Here are the translations of the Python keywords you provided into Greek:

1. Count: μετρώ (metron)
2. Encode: κωδικοποίηση (kodikopoiisis)
3. Ends with: τελείωση (teleiosis)
4. Expand tabs: έναρξη καρτέλων (enarxi kartelon)
5. Find: αναζήτηση (anazitisi)
6. Format map: χάρτης μετάφρasis (chartis metaphrasis)
7. Index: ίνдекс (index)
8. Is alphanumeric: είναι αλφαβητικό (einai alfabetiko)
9. Is alphabetic: είναι αλφαβητικό (einai alfabetiko)
10. Is ASCII: είναι ASCII (einai ASCII)

I hope this helps you with your project! If you have any further questions or need additional assistance, please don't hesitate to ask.
 Sure, I'd be happy to help you with that! Here are the translations of the Python keywords you provided into Greek:

* "is decimal" -> "είναι δοχμικό" (eínai dochmikó)
* "is digit" -> "είναι ψηφίδι" (eínai psifídhi)
* "is identifier" -> "είναι πρωτογενής όρο" (eínai protogenēs óro)
* "is lower" -> "είναι λειτογράφι" (eínai leitográfi)
* "is numeric" -> "είναι αριθμητικό" (eínai arithmétiko)
* "is printable" -> "είναι εκτυπώσιμο" (eínai ektípōsimo)
* "is space" -> "είναι χώρος" (eínai chos)
* "is title" -> "είναι τίτλος" (eínai títtlos)
* "is uppercase" -> "είναι μεγálη γράμματα" (eínai megálē grammata)
* "join" -> "συνδέομαι" (syndeómai)

I hope this helps! Let me know if you have any other questions.
 Sure, I'd be happy to help you with that! Here are the translations of the Python keywords you provided into Greek:

* Left justify: Αριστερή Σύνδεση (Aristeri Sýndesis)
* Lower: Κάτω (Káto)
* Left strip: Αριστερός Πίνακος (Aristeros Pínakos)
* Make translation: Μετάφrasis (Metáphrasis)
* Partition: Σχίζουμενο (Schízoumeno)
* Replace: Αντιστοιχίζειν (Antistroicheízen)
* Reverse find: Αναγωγή προς παλαιότερο (Anagōgē prós paleótero)
* Reverse index: Πίνακος προς παλαιότερο (Pínakos prós paleótero)
* Right justify: Δεξιά Σύνδεση (Dexia Sýndesis)
* Right partition: Δεξιός Πίνακος (Dexios Pínakos)

I hope these translations are helpful for your project! If you have any further questions or need additional assistance, please don't hesitate to ask.
 Sure, I'd be happy to help you with that! Here are the translations of the Python key terms you provided into Greek:

* Right split: Δεντροποίηση (Dentropoiesi)
* Right strip: Απόκοπη (Apopkope)
* Split: Σχίζω (Schizo)
* Split lines: Λιγνύρες (Ligyneres)
* Starts with: Ξεφテ (Xefthe)
* Strip: Απόκοπη (Apopkope)
* Swap case: Αλλαγή (Allagē)
* Title: Τίτλος (Titlos)
* Translate: Μετάφραση (Metaphraze)
* Uppercase: Πρωτογενή (Protogenē)

I hope this helps you with your project! If you have any further questions or need any additional assistance, please don't hesitate to ask.
 Sure, I'd be happy to help you with that! Here are the translations of the Python key terms you provided into Greek:

* Zero fill: μηδενιστή πλήρωση (midenistis plirōsē)
* Append: προσθήκη (prosthēkī)
* Clear: εκαθάριση (ekathārisē)
* Copy: αντίγrafhein (antigrafein)
* Extend: ένταξη (entaxē)
* Insert: εἰσόδος (eisodos)
* Pop: έκβαση (ekvasē)
* Remove: ἀφαίρεση (aphairesis)
* Reverse: προσανατολή (prosanatolē)
* Sort: ταξινόμηση (taxinomēsē)

I hope this helps you with your project! If you have any further questions or need additional assistance, please don't hesitate to ask.
 Sure, I'd be happy to help you with that! Here are the translations of the Python key terms you provided into Greek:

* "from" = προέλεση (proelesi)
* "keys" = κλειδία (kleidia)
* "get" = πάντα (panta)
* "items" = απόσπες (apospes)
* "pop item" = μεταβλητήστε (metabliteste)
* "set default" = ορίζειν (orizein)
* "update" = ενημερωτική (enimerotiki)
* "values" = τιμές (times)
* "add" = προσθήκη (prosthiki)
* "difference" = διαφορά (diafora)

I hope this helps you with your project! If you have any further questions or need additional assistance, please don't hesitate to ask.
 Sure, I'd be happy to help you with that! Here are the translations of the Python key terms you provided into Greek:

* Difference update: Διαφορά ενημέρωση (Diafora enimerosis)
* Discard: Απόβεβλητήριο (Apoblevterio)
* Intersection: Συναφών (Synafon)
* Intersection update: Συναφών ενημέρωση (Synafon enimerosis)
* Is disjoint: Είναι διαχωριστό (Einai diachōristo)
* Is subset: Είναι συμμετοχή (Einai symmeTOkhi)
* Is superset: Είναι υπερκείμενο (Einai yperekimeno)
* Symmetric difference: Ισορροπía (Isorropia)
* Symmetric difference update: Ισορροπία ενημέρωση (Isorropia enimerosis)
* Union: Ένωση (Enosis)

I hope this helps you with your project! If you have any other questions or need further assistance, please don't hesitate to ask.
 Sure, I'd be happy to help you with that! Here are the translations of the Python key terms you provided into Greek:

* close: κλοπή (klopi)
* detach: απομακρυστήν (apomakrystini)
* file number: αριθμός ἀρχείων (arithmos archion)
* flush: καθαρισμός (katharismos)
* is interactive: εἰ ἐν interactive (i en interactive)
* read: ἀνάγνωση (anagnosis)
* readable: διαβαζόμενο (diabazomeno)
* read line: ἀνάγνωση γραμμῆς (anagnosis grammis)
* read lines: ἀνάγνωση γραμμών (anagnosis grammon)
* seek: ψηφίζηση (psifidisi)

I hope these translations are helpful for your project! If you have any further questions or need additional assistance, please don't hesitate to ask.
 Sure, I'd be happy to help you with that! Here are the translations of the Python keywords you provided into Greek:

* seekable: ψηφιζόμενο (psifizomeno)
* tell: ρήγελτα (rigelta)
* truncate: κοπίδω (kopido)
* writable: γράμμαστiko (grammastiko)
* write: γράφω (grapfo)
* write lines: γράφω γραμμές (grapfo grammes)
* and: και (kai)
* assert: αποδεικτικό (apodeiktiko)
* break: ρυθμιστικό (rythmistiko)

I hope this helps you with your project! If you have any other questions or need further assistance, feel free to ask.
 Sure, I'd be happy to help you with that! Here are the translations of the Python keywords you provided into Greek:

* class: κλάση (klasi)
* continue: συνέχεια (synechia)
* define: ορίζοντας (orizontas)
* delete: διαγραφή (diagrafi)
* else if: αλλος εἰ μὴ (allos ei mi)
* else: ἄλλος (allos)
* except: πληθυσμός (plithysmos)
* False: ψεῦδος (pseudos)
* finally: γingerly (gingerly)
* for: για (gia)

I hope this helps! Note that the translations are written in the Greek alphabet, so you may need to adjust them slightly depending on the encoding used in your coding environment.
 Sure, I'd be happy to help you with that! Here are the translations of the Python keywords you provided into Greek:

* "from" = προέλεση (proelesi)
* "global" = γлоβαλ (globali)
* "if" = εάν (ean)
* "import" = ιμπορτ (import)
* "in" = σε (se)
* "is" = είναι (inai)
* "lambda" = λάμδα (lamda)
* "None" = καθόλου (katholou)
* "non-local" = προσωπικός (prosopeikos)
* "not" = όχι (ochi)

I hope this helps you with your project! If you have any other questions or need further assistance, feel free to ask.
 Sure, I'd be happy to help you with that! Here are the translations of the Python keywords you provided into Greek:

* or: ή ορ (pronounced "i or")
* pass: παράσταση (pronounced "parastasis")
* raise exception: εκπλήξις (pronounced "ekplis")
* return: επιστροφή (pronounced "epistrofi")
* True: αληθινό (pronounced "alithinio")
* try: προσπαθεία (pronounced "prospathia")
* while: μέχρι (pronounced "mechri")
* with: συν (pronounced "syn")
* yield: προδοτικό (pronounced "prodotiko")
* Arithmetic Error: Σφالμα Αριθμητικής (pronounced "sphalmata arithmeticis")

I hope this helps you with your project! If you have any further questions or need additional assistance, please don't hesitate to ask.
 Sure, I'd be happy to help you with that! Here are the translations of the Python key terms you provided into Greek:

1. Assertion Error - Σφάλμα Πιστοποίησης (Sfalmata Pistopoiisis)
2. Attribute Error - Σφάλμα Προόδου (Sfalmata Proodou)
3. Exception - Εκτέβεισις (Ektebaisis)
4. End Of File Error - Σφάλμα Τελείων Αρχείων (Sfalmata Telion Archeion)
5. Floating Point Error - Σφάλμα Λεπτού Χαθή (Sfalmata Leptou Chathi)
6. Generator Exit - Έξοδος Γενερατορα (Exodos Genitora)
7. Import Error - Σφάλμα Εἰσαγωγῆς (Sfalmata Eisagogis)
8. Indentation Error - Σφάλμα Κατακαυリσμοῦ (Sfalmata Katakauismou)
9. Index Error - Σφάλμα Δείκτη (Sfalmata Deikti)
10. Key Error - Σφάλμα Κλειδίου (Sfalmata Kleidiou)

I hope these translations are helpful to you! Note that the Greek terms may vary depending on the context and the specific terminology used in Python programming.
 Sure, I'd be happy to help you with that! Here are the translations of the Python key terms you provided into Greek:

1. Keyboard Interrupt - Επισύναψη κλήστρου (Episynapsē klistrou)
2. Lookup Error - Σφάλμα αναζητής (Sfálma anazitīs)
3. Memory Error - Σφάλμα μνήμης (Sfálma mnimis)
4. Name Error - Σφάλμα όνοματος (Sfálma onomatos)
5. Not Implemented Error - Σφάλμα εγκατάστασης (Sfálma engkatástasēs)
6. OS Error - Σφάλμα Οпераτιβg Συστήματος (Sfálma Operating Systemos)
7. Overflow Error - Σφάλμα πλήθος (Sfálma plēthos)
8. Reference Error - Σφάλμα αναφορής (Sfálma anaphōrēs)
9. Runtime Error - Σφάλμα χρόνου (Sfálma chronou)
10. Stop Iteration - Σφάλμα διακοπής επαναληψίδα (Sfálma diakopēs epanalipseos)

I hope these translations are helpful! Let me know if you have any further questions or need any additional assistance.
 Sure, I'd be happy to help you with that! Here are the translations of the Python keywords you provided into Greek:

1. Syntax Error - Σύνταξη Σφάλμα (Syntaxis Sfalmma)
2. Tab Error - Εστία Σφάλμα (Estia Sfalmma)
3. System Error - Συστήματico Σφάλμα (Systematiko Sfalmma)
4. System Exit - Εξόδος Συστήματος (Exodos Systematos)
5. Type Error - Τύπο Σφάλμα (Typo Sfalmma)
6. Unbound Local Error - Ακρωτή Λοкаль Σφάλμα (Akrotiki Logika Sfalmma)
7. Unicode Error - Κωδικός Σφάλμα  Unicode (Kodikos Sfalmma Unicode)
8. Unicode Encode Error - Σφάλμα Κωδικοποίησης Unicode (Sfalmma Kodikopoiisis Unicode)
9. Unicode Decode Error - Σφάλμα Δεκοδικοποίησης Unicode (Sfalmma Dekodikopoiisis Unicode)
10. Unicode Translate Error - Σφάλμα Μεταφράσεως Unicode (Sfalmma Metaphraseos Unicode)

I hope these translations are helpful to you! Let me know if you have any other questions or need further assistance.
 Sure, I'd be happy to help! Here are the translations for the two terms you provided:

* Value Error: Σφάλμα τιμής (Sphálma tis timís)
* Zero Division Error: Σφάλμα διαίρεσης μέρου  zero (Sphálma diaíresis merou zero)

I hope this helps! Let me know if you have any other questions or need further assistance.
