, class method, compile, complex, delete attribute, dictionary, directory, divide modulus, enumerate, evaluate, execute, filter, floating point, format, frozen set, get attribute, globals, has attribute, hash, help, hexadecimal, identity, input, integer, is instance, is subclass, iterator, length, list, locals, map, maximum, memory view, minimum, next, object, octal, open, ordinal, power, print, property, range, represent, reversed, round, set, set attribute, slice, sorted, static method, string, summation, superset, tuple, type, variables, zip, capitalize, case fold, center, count, encode, ends with, expand tabs, find, format map, index, is alphanumeric, is alphabetic, is ascii, is decimal, is digit, is identifier, is lower, is numeric, is printable, is space, is title, is uppercase, join, left justify, lower, left strip, make translation, partition, replace, reverse find, reverse index, right justify, right partition, right split, right strip, split, split lines, starts with, strip, swap case, title, translate, uppercase, zero fill, append, clear, copy, extend, insert, pop, remove, reverse, sort, from keys, get, items, keys, pop item, set default, update, values, add, difference, difference update, discard, intersection, intersection update, is disjoint, is subset, is superset, symmetric difference, symmetric difference update, union, close, detach, file number, flush, is interactive, read, readable, read line, read lines, seek, seekable, tell, truncate, writable, write, write lines, and, as, assert, break, class, continue, define, delete, else if, else, except, False, finally, for, from, global, if, import, in, is, lambda, None, non-local, not, or, pass, raise exception, return, True, try, while, with, yield, Arithmetic Error, Assertion Error, Attribute Error, Exception, End Of File Error, Floating Point Error, Generator Exit, Import Error, Indentation Error, Index Error, Key Error, Keyboard Interrupt, Lookup Error, Memory Error, Name Error, Not Implemented Error, OS Error, Overflow Error, Reference Error, Runtime Error, Stop Iteration, Syntax Error, Tab Error, System Error, System Exit, Type Error, Unbound Local Error, Unicode Error, Unicode Encode Error, Unicode Decode Error, Unicode Translate Error, Value Error, Zero Division Error

Valeur absolue, tout, n'importe quoi, ascii, binaire, booléen, tableau d'octets, octets, appelable, caractère, méthode de classe, compiler, complexe, supprimer l'attribut, dictionnaire, répertoire, diviser le modulo, énumérer, évaluer, exécuter, filtrer, point flottant, format, ensemble figé, obtenir l'attribut, globaux, a l'attribut, hachage, aide, hexadécimal, identité, entrée, entier, est instance, est sous-classe, itérateur, longueur, liste, locaux, carte, maximum, vue de la mémoire, minimum, prochain, objet, octal, ouvert, ordinal, puissance, imprimer, propriété, gamme, représenter, inversé, tour, ensemble, définir l'attribut, tranche, trié, méthode statique, chaîne, somme, sur-ensemble, tuple, type, variables, fermeture éclair, capitaliser, plier la cas, centrer, compter, encoder, se termine par, étendre les onglets, trouver, format de carte, index, est alphanumérique, est alphabétique, est ascii, est décimal, est chiffre, est identifiant, est inférieur, est numérique, est imprimable, est espace, est titre, est majuscule, rejoindre, justifier à gauche, inférieur, bande gauche, faire la traduction, partition, remplacer, trouver inverse, index inverse, justifier à droite, partition à droite, diviser à droite, bande droite, diviser, lignes divisé
, filter, floating point, format, frozen set, get attribute, globals, has attribute, hash, help, hexadecimal, identity, input, integer, is instance, is subclass, iterator, length, list, locals, map, maximum, memory view, minimum, next, object, octal, open, ordinal, power, print, property, range, represent, reversed, round, set, set attribute, slice, sorted, static method, string, summation, superset, tuple, type, variables, zip, capitalize, case fold, center, count, encode, ends with, expand tabs, find, format map, index, is alphanumeric, is alphabetic, is ascii, is decimal, is digit, is identifier, is lower, is numeric, is printable, is space, is title, is uppercase, join, left justify, lower, left strip, make translation, partition, replace, reverse find, reverse index, right justify, right partition, right split, right strip, split, split lines, starts with, strip, swap case, title, translate, uppercase, zero fill, append, clear, copy, extend, insert, pop, remove, reverse, sort, from keys, get, items, keys, pop item, set default, update, values, add, difference, difference update, discard, intersection, intersection update, is disjoint, is subset, is superset, symmetric difference, symmetric difference update, union, close, detach, file number, flush, is interactive, read, readable, read line, read lines, seek, seekable, tell, truncate, writable, write, write lines, and, as, assert, break, class, continue, define, delete, else if, else, except, False, finally, for, from, global, if, import, in, is, lambda, None, non-local, not, or, pass, raise exception, return, True, try, while, with, yield, Arithmetic Error, Assertion Error, Attribute Error, Exception, End Of File Error, Floating Point Error, Generator Exit, Import Error, Indentation Error, Index Error, Key Error, Keyboard Interrupt, Lookup Error, Memory Error, Name Error, Not Implemented Error, OS Error, Overflow Error, Reference Error, Runtime Error, Stop Iteration, Syntax Error, Tab Error, System Error, System Exit, Type Error, Unbound Local Error, Unicode Error, Unicode Encode Error, Unicode Decode Error, Unicode Translate Error, Value Error, Zero Division Error

Méthode de classe, compiler, complexe, supprimer l'attribut, dictionnaire, répertoire, modulo de division, énumérer, évaluer, exécuter, filtrer, point flottant, format, ensemble figé, obtenir l'attribut, globaux, a l'attribut, hachage, aide, hexadécimal, identité, entrée, entier, est une instance, est une sous-classe, itérateur, longueur, liste, locaux, carte, maximum, vue mémoire, minimum, prochain, objet, octal, ouvert, ordinal, puissance, imprimer, propriété, gamme, représenter, inversé, arrondi, ensemble, définir l'attribut, tranche, trié, méthode statique, chaîne, somme, sur-ensemble, tuple, type, variables, fermeture éclair, capitaliser, plier le cas, centrer, compter, encoder, se termine par, étendre les onglets, trouver, format de carte, index, est alphanumérique, est alphabétique, est ascii, est décimal, est un chiffre, est un identifiant, est inférieur, est numérique, est imprimable, est espace, est titre, est majuscule, rejoindre, justifier à gauche, plus bas, bande gauche, faire la traduction, partition, remplacer, trouver inverse, index inverse, justifier à droite, partition droite, diviser à droite, bande droite, diviser, diviser les lignes, commence par, bande, échange de cas, titre, traduire, majuscule, remplir à zéro, ajouter, clair, copier, étendre, insérer, pop, supprimer, inverser, trier, de clés, obtenir, articles
, identity, input, integer, is instance, is subclass, iterator, length, list, locals, map, maximum, memory view, minimum, next, object, octal, open, ordinal, power, print, property, range, represent, reversed, round, set, set attribute, slice, sorted, static method, string, summation, superset, tuple, type, variables, zip, capitalize, case fold, center, count, encode, ends with, expand tabs, find, format map, index, is alphanumeric, is alphabetic, is ascii, is decimal, is digit, is identifier, is lower, is numeric, is printable, is space, is title, is uppercase, join, left justify, lower, left strip, make translation, partition, replace, reverse find, reverse index, right justify, right partition, right split, right strip, split, split lines, starts with, strip, swap case, title, translate, uppercase, zero fill, append, clear, copy, extend, insert, pop, remove, reverse, sort, from keys, get, items, keys, pop item, set default, update, values, add, difference, difference update, discard, intersection, intersection update, is disjoint, is subset, is superset, symmetric difference, symmetric difference update, union, close, detach, file number, flush, is interactive, read, readable, read line, read lines, seek, seekable, tell, truncate, writable, write, write lines, and, as, assert, break, class, continue, define, delete, else if, else, except, False, finally, for, from, global, if, import, in, is, lambda, None, non-local, not, or, pass, raise exception, return, True, try, while, with, yield, Arithmetic Error, Assertion Error, Attribute Error, Exception, End Of File Error, Floating Point Error, Generator Exit, Import Error, Indentation Error, Index Error, Key Error, Keyboard Interrupt, Lookup Error, Memory Error, Name Error, Not Implemented Error, OS Error, Overflow Error, Reference Error, Runtime Error, Stop Iteration, Syntax Error, Tab Error, System Error, System Exit, Type Error, Unbound Local Error, Unicode Error, Unicode Encode Error, Unicode Decode Error, Unicode Translate Error, Value Error, Zero Division Error

Filter => Filtrer
Floating Point => Point Flottant
Format => Formater
Frozen Set => Ensemble Congelé
Get Attribute => Obtenir Attribut
Globals => Globaux
Has Attribute => A Attribut
Hash => Hacher
Help => Aide
Hexadecimal => Hexadécimal
Identity => Identité
Input => Entrée
Integer => Entier
Is Instance => Est Instance
Is Subclass => Est Sous-Classe
Iterator => Itérateur
Length => Longueur
List => Liste
Locals => Locaux
Map => Mapper
Maximum => Maximum
Memory View => Vue Mémoire
Minimum => Minimum
Next => Suivant
Object => Objet
Octal => Octal
Open => Ouvrir
Ordinal => Ordinal
Power => Puissance
Print => Imprimer
Property => Propriété
Range => Plage
Represent => Représenter
Reversed => Inversé
Round => Arrondir
Set => Ensemble
Set Attribute => Définir Attribut
Slice => Tranche
Sorted => Trié
Static Method => Méthode Statique
String => Chaîne
Summation => Somme
Superset => Super-Ensemble
Tuple => Tuple
Type => Type
Variables => Variables
Zip => Compresser
Capitalize => Majusculer
Case Fold => Plier Cas
Center => Centrer
Count => Compter
Encode => Encoder
Ends With => Se Termine Par
Expand Tabs => Élargir Les Tabulations
Find => Trouver
Format Map => Mapper Format
Index => Indexer
Is Alphanumeric => Est Alphanumérique
Is Alphabetic => Est Alphabétique
Is Ascii => Est Ascii
Is Decimal => Est Décimal
Is Digit => Est Chiffre
Is Identifier => Est Identifiant
Is Lower => Est Minuscule
Is Numeric => Est Numérique
Is Printable => Est Imprimable
Is Space => Est Espace
Is Title => Est Titre
Is Uppercase => Est Majuscule
Join => Joindre
Left Justify =>
, maximum, memory view, minimum, next, object, octal, open, ordinal, power, print, property, range, represent, reversed, round, set, set attribute, slice, sorted, static method, string, summation, superset, tuple, type, variables, zip, capitalize, case fold, center, count, encode, ends with, expand tabs, find, format map, index, is alphanumeric, is alphabetic, is ascii, is decimal, is digit, is identifier, is lower, is numeric, is printable, is space, is title, is uppercase, join, left justify, lower, left strip, make translation, partition, replace, reverse find, reverse index, right justify, right partition, right split, right strip, split, split lines, starts with, strip, swap case, title, translate, uppercase, zero fill, append, clear, copy, extend, insert, pop, remove, reverse, sort, from keys, get, items, keys, pop item, set default, update, values, add, difference, difference update, discard, intersection, intersection update, is disjoint, is subset, is superset, symmetric difference, symmetric difference update, union, close, detach, file number, flush, is interactive, read, readable, read line, read lines, seek, seekable, tell, truncate, writable, write, write lines, and, as, assert, break, class, continue, define, delete, else if, else, except, False, finally, for, from, global, if, import, in, is, lambda, None, non-local, not, or, pass, raise exception, return, True, try, while, with, yield, Arithmetic Error, Assertion Error, Attribute Error, Exception, End Of File Error, Floating Point Error, Generator Exit, Import Error, Indentation Error, Index Error, Key Error, Keyboard Interrupt, Lookup Error, Memory Error, Name Error, Not Implemented Error, OS Error, Overflow Error, Reference Error, Runtime Error, Stop Iteration, Syntax Error, Tab Error, System Error, System Exit, Type Error, Unbound Local Error, Unicode Error, Unicode Encode Error, Unicode Decode Error, Unicode Translate Error, Value Error, Zero Division Error

Identity => Identité, Input => Entrée, Integer => Entier, Is instance => Est une instance, Is subclass => Est une sous-classe, Iterator => Itérateur, Length => Longueur, List => Liste, Locals => Locaux, Map => Carte, Maximum => Maximum, Memory view => Vue mémoire, Minimum => Minimum, Next => Suivant, Object => Objet, Octal => Octal, Open => Ouvert, Ordinal => Ordinal, Power => Puissance, Print => Imprimer, Property => Propriété, Range => Gamme, Represent => Représenter, Reversed => Inversé, Round => Arrondi, Set => Ensemble, Set attribute => Définir l'attribut, Slice => Tranche, Sorted => Trié, Static method => Méthode statique, String => Chaîne, Summation => Somme, Superset => Super-ensemble, Tuple => Tuple, Type => Type, Variables => Variables, Zip => Zip, Capitalize => Mettre en majuscule, Case fold => Plier la cas, Center => Centrer, Count => Compter, Encode => Encoder, Ends with => Se termine par, Expand tabs => Étendre les tabulations, Find => Trouver, Format map => Formater la carte, Index => Index, Is alphanumeric => Est alphanumérique, Is alphabetic => Est alphabétique, Is ascii => Est ascii, Is decimal => Est décimal, Is digit => Est un chiffre, Is identifier => Est un identifiant, Is lower => Est en minuscule, Is numeric => Est numérique, Is printable => Est imprimable, Is space => Est un espace, Is title => Est un titre, Is uppercase => Est en majuscule, Join => Joindre, Left justify => Justifier à gauche, Lower => Minuscule, Left strip => Retirer à gauche, Make translation => Faire la traduction, Partition => Partition, Replace => Remplacer, Reverse find => Recherche inverse, Reverse index => Index inversé, Right justify => Justifier à droite, Right partition => Partition à droite, Right split => Diviser à droite, Right strip => Retirer à droite
, property, range, represent, reversed, round, set, set attribute, slice, sorted, static method, string, summation, superset, tuple, type, variables, zip, capitalize, case fold, center, count, encode, ends with, expand tabs, find, format map, index, is alphanumeric, is alphabetic, is ascii, is decimal, is digit, is identifier, is lower, is numeric, is printable, is space, is title, is uppercase, join, left justify, lower, left strip, make translation, partition, replace, reverse find, reverse index, right justify, right partition, right split, right strip, split, split lines, starts with, strip, swap case, title, translate, uppercase, zero fill, append, clear, copy, extend, insert, pop, remove, reverse, sort, from keys, get, items, keys, pop item, set default, update, values, add, difference, difference update, discard, intersection, intersection update, is disjoint, is subset, is superset, symmetric difference, symmetric difference update, union, close, detach, file number, flush, is interactive, read, readable, read line, read lines, seek, seekable, tell, truncate, writable, write, write lines, and, as, assert, break, class, continue, define, delete, else if, else, except, False, finally, for, from, global, if, import, in, is, lambda, None, non-local, not, or, pass, raise exception, return, True, try, while, with, yield, Arithmetic Error, Assertion Error, Attribute Error, Exception, End Of File Error, Floating Point Error, Generator Exit, Import Error, Indentation Error, Index Error, Key Error, Keyboard Interrupt, Lookup Error, Memory Error, Name Error, Not Implemented Error, OS Error, Overflow Error, Reference Error, Runtime Error, Stop Iteration, Syntax Error, Tab Error, System Error, System Exit, Type Error, Unbound Local Error, Unicode Error, Unicode Encode Error, Unicode Decode Error, Unicode Translate Error, Value Error, Zero Division Error

maximum => maximum, memory view => vue mémoire, minimum => minimum, next => suivant, object => objet, octal => octal, open => ouvrir, ordinal => ordinal, power => puissance, print => imprimer, property => propriété, range => gamme, represent => représenter, reversed => inversé, round => arrondir, set => ensemble, set attribute => définir l'attribut, slice => tranche, sorted => trié, static method => méthode statique, string => chaîne, summation => somme, superset => super ensemble, tuple => tuple, type => type, variables => variables, zip => fermeture éclair, capitalize => majuscule, case fold => pliage de cas, center => centrer, count => compter, encode => encoder, ends with => se termine par, expand tabs => étendre les onglets, find => trouver, format map => mappeur de format, index => index, is alphanumeric => est alphanumérique, is alphabetic => est alphabétique, is ascii => est ascii, is decimal => est décimal, is digit => est un chiffre, is identifier => est un identifiant, is lower => est inférieur, is numeric => est numérique, is printable => est imprimable, is space => est un espace, is title => est un titre, is uppercase => est en majuscules, join => rejoindre, left justify => justifier à gauche, lower => plus bas, left strip => bande gauche, make translation => faire la traduction, partition => partition, replace => remplacer, reverse find => trouver inversement, reverse index => index inversé, right justify => justifier à droite, right partition => partition droite, right split => diviser à droite, right strip => bande droite, split => diviser, split lines => diviser les lignes, starts with => commence par, strip => bande, swap case => échanger les cas, title => titre, translate => traduire, uppercase => majuscules, zero fill => remplir de zéro, append => ajouter, clear => clair, copy => copier, extend => étendre, insert => insérer, pop => sauter, remove => supprimer, reverse => inverser, sort =>
, string, summation, superset, tuple, type, variables, zip, capitalize, case fold, center, count, encode, ends with, expand tabs, find, format map, index, is alphanumeric, is alphabetic, is ascii, is decimal, is digit, is identifier, is lower, is numeric, is printable, is space, is title, is uppercase, join, left justify, lower, left strip, make translation, partition, replace, reverse find, reverse index, right justify, right partition, right split, right strip, split, split lines, starts with, strip, swap case, title, translate, uppercase, zero fill, append, clear, copy, extend, insert, pop, remove, reverse, sort, from keys, get, items, keys, pop item, set default, update, values, add, difference, difference update, discard, intersection, intersection update, is disjoint, is subset, is superset, symmetric difference, symmetric difference update, union, close, detach, file number, flush, is interactive, read, readable, read line, read lines, seek, seekable, tell, truncate, writable, write, write lines, and, as, assert, break, class, continue, define, delete, else if, else, except, False, finally, for, from, global, if, import, in, is, lambda, None, non-local, not, or, pass, raise exception, return, True, try, while, with, yield, Arithmetic Error, Assertion Error, Attribute Error, Exception, End Of File Error, Floating Point Error, Generator Exit, Import Error, Indentation Error, Index Error, Key Error, Keyboard Interrupt, Lookup Error, Memory Error, Name Error, Not Implemented Error, OS Error, Overflow Error, Reference Error, Runtime Error, Stop Iteration, Syntax Error, Tab Error, System Error, System Exit, Type Error, Unbound Local Error, Unicode Error, Unicode Encode Error, Unicode Decode Error, Unicode Translate Error, Value Error, Zero Division Error

property => propriété, range => plage, represent => représenter, reversed => inversé, round => arrondir, set => ensemble, set attribute => définir l'attribut, slice => tranche, sorted => trié, static method => méthode statique, string => chaîne, summation => somme, superset => ensemble supérieur, tuple => tuple, type => type, variables => variables, zip => fermeture éclair, capitalize => majuscule, case fold => pliage de cas, center => centrer, count => compter, encode => encoder, ends with => se termine par, expand tabs => étendre les onglets, find => trouver, format map => carte de format, index => index, is alphanumeric => est alphanumérique, is alphabetic => est alphabétique, is ascii => est ascii, is decimal => est décimal, is digit => est un chiffre, is identifier => est un identifiant, is lower => est en minuscule, is numeric => est numérique, is printable => est imprimable, is space => est un espace, is title => est un titre, is uppercase => est en majuscule, join => joindre, left justify => justifier à gauche, lower => minuscule, left strip => bande gauche, make translation => faire une traduction, partition => partition, replace => remplacer, reverse find => recherche inversée, reverse index => index inverse, right justify => justifier à droite, right partition => partition droite, right split => partage droit, right strip => bande droite, split => diviser, split lines => lignes séparées, starts with => commence par, strip => bande, swap case => échanger le cas, title => titre, translate => traduire, uppercase => majuscule, zero fill => remplissage de zéro, append => ajouter, clear => effacer, copy => copier, extend => étendre, insert => insérer, pop => retrait, remove => supprimer, reverse => inverser, sort => trier, from keys => des clés, get => obtenir, items => articles, keys => clés, pop item => élément de pop, set default => définir par défaut, update => mettre à jour, values => valeurs, add => ajouter, difference => différence, difference update => mise
, count, encode, ends with, expand tabs, find, format map, index, is alphanumeric, is alphabetic, is ascii, is decimal, is digit, is identifier, is lower, is numeric, is printable, is space, is title, is uppercase, join, left justify, lower, left strip, make translation, partition, replace, reverse find, reverse index, right justify, right partition, right split, right strip, split, split lines, starts with, strip, swap case, title, translate, uppercase, zero fill, append, clear, copy, extend, insert, pop, remove, reverse, sort, from keys, get, items, keys, pop item, set default, update, values, add, difference, difference update, discard, intersection, intersection update, is disjoint, is subset, is superset, symmetric difference, symmetric difference update, union, close, detach, file number, flush, is interactive, read, readable, read line, read lines, seek, seekable, tell, truncate, writable, write, write lines, and, as, assert, break, class, continue, define, delete, else if, else, except, False, finally, for, from, global, if, import, in, is, lambda, None, non-local, not, or, pass, raise exception, return, True, try, while, with, yield, Arithmetic Error, Assertion Error, Attribute Error, Exception, End Of File Error, Floating Point Error, Generator Exit, Import Error, Indentation Error, Index Error, Key Error, Keyboard Interrupt, Lookup Error, Memory Error, Name Error, Not Implemented Error, OS Error, Overflow Error, Reference Error, Runtime Error, Stop Iteration, Syntax Error, Tab Error, System Error, System Exit, Type Error, Unbound Local Error, Unicode Error, Unicode Encode Error, Unicode Decode Error, Unicode Translate Error, Value Error, Zero Division Error

String => Chaîne, summation => somme, superset => ensemble supérieur, tuple => tuple, type => type, variables => variables, zip => fermeture éclair, capitalize => capitaliser, case fold => plier la casse, center => centrer, count => compter, encode => encoder, ends with => se termine par, expand tabs => étendre les onglets, find => trouver, format map => mapper le format, index => index, is alphanumeric => est alphanumérique, is alphabetic => est alphabétique, is ascii => est ascii, is decimal => est décimal, is digit => est chiffre, is identifier => est identificateur, is lower => est inférieur, is numeric => est numérique, is printable => est imprimable, is space => est espace, is title => est titre, is uppercase => est majuscule, join => joindre, left justify => justifier à gauche, lower => inférieur, left strip => bande gauche, make translation => faire la traduction, partition => partitionner, replace => remplacer, reverse find => trouver inversement, reverse index => index inversé, right justify => justifier à droite, right partition => partition droite, right split => diviser à droite, right strip => bande droite, split => diviser, split lines => diviser les lignes, starts with => commence par, strip => bande, swap case => échanger les cas, title => titre, translate => traduire, uppercase => majuscule, zero fill => remplir de zéros, append => ajouter, clear => effacer, copy => copier, extend => étendre, insert => insérer, pop => sauter, remove => supprimer, reverse => inverser, sort => trier, from keys => à partir des clés, get => obtenir, items => éléments, keys => clés, pop item => élément sauté, set default => définir par défaut, update => mettre à jour, values => valeurs, add => ajouter, difference => différence, difference update => mettre à jour la différence, discard => écarter, intersection => intersection, intersection update => mettre à jour l'intersection, is disjoint => est disjoint, is subset => est un sous-ensemble, is superset => est un ensemble supérieur, symmetric difference => différence symétrique, symmetric difference update => mettre à jour la différence
, is decimal, is digit, is identifier, is lower, is numeric, is printable, is space, is title, is uppercase, join, left justify, lower, left strip, make translation, partition, replace, reverse find, reverse index, right justify, right partition, right split, right strip, split, split lines, starts with, strip, swap case, title, translate, uppercase, zero fill, append, clear, copy, extend, insert, pop, remove, reverse, sort, from keys, get, items, keys, pop item, set default, update, values, add, difference, difference update, discard, intersection, intersection update, is disjoint, is subset, is superset, symmetric difference, symmetric difference update, union, close, detach, file number, flush, is interactive, read, readable, read line, read lines, seek, seekable, tell, truncate, writable, write, write lines, and, as, assert, break, class, continue, define, delete, else if, else, except, False, finally, for, from, global, if, import, in, is, lambda, None, non-local, not, or, pass, raise exception, return, True, try, while, with, yield, Arithmetic Error, Assertion Error, Attribute Error, Exception, End Of File Error, Floating Point Error, Generator Exit, Import Error, Indentation Error, Index Error, Key Error, Keyboard Interrupt, Lookup Error, Memory Error, Name Error, Not Implemented Error, OS Error, Overflow Error, Reference Error, Runtime Error, Stop Iteration, Syntax Error, Tab Error, System Error, System Exit, Type Error, Unbound Local Error, Unicode Error, Unicode Encode Error, Unicode Decode Error, Unicode Translate Error, Value Error, Zero Division Error

count => compter, encode => encoder, ends with => se termine par, expand tabs => étendre les onglets, find => trouver, format map => mappe de format, index => index, is alphanumeric => est alphanumérique, is alphabetic => est alphabétique, is ascii => est ascii, is decimal => est décimal, is digit => est un chiffre, is identifier => est un identifiant, is lower => est en minuscule, is numeric => est numérique, is printable => est imprimable, is space => est un espace, is title => est un titre, is uppercase => est en majuscule, join => joindre, left justify => justifier à gauche, lower => minuscule, left strip => enlever à gauche, make translation => faire la traduction, partition => partition, replace => remplacer, reverse find => recherche inverse, reverse index => index inverse, right justify => justifier à droite, right partition => partition à droite, right split => diviser à droite, right strip => enlever à droite, split => diviser, split lines => diviser les lignes, starts with => commence par, strip => enlever, swap case => échanger les cas, title => titre, translate => traduire, uppercase => majuscule, zero fill => remplir de zéros, append => ajouter, clear => effacer, copy => copier, extend => étendre, insert => insérer, pop => extraire, remove => supprimer, reverse => inverser, sort => trier, from keys => à partir des clés, get => obtenir, items => éléments, keys => clés, pop item => extraire un élément, set default => définir par défaut, update => mettre à jour, values => valeurs, add => ajouter, difference => différence, difference update => mettre à jour la différence, discard => jeter, intersection => intersection, intersection update => mettre à jour l'intersection, is disjoint => est disjoint, is subset => est un sous-ensemble, is superset => est un sur-ensemble, symmetric difference => différence symétrique, symmetric difference update => mettre à jour la différence symétrique, union => union, close => fermer, detach => détacher, file number => numéro de fichier, flush => vider, is interactive => est interactif, read => lire, readable => lisible, read line => lire la ligne, read lines => lire les lignes, seek => chercher, seekable => recherchable, tell =>
, left justify, lower, left strip, make translation, partition, replace, reverse find, reverse index, right justify, right partition, right split, right strip, split, split lines, starts with, strip, swap case, title, translate, uppercase, zero fill, append, clear, copy, extend, insert, pop, remove, reverse, sort, from keys, get, items, keys, pop item, set default, update, values, add, difference, difference update, discard, intersection, intersection update, is disjoint, is subset, is superset, symmetric difference, symmetric difference update, union, close, detach, file number, flush, is interactive, read, readable, read line, read lines, seek, seekable, tell, truncate, writable, write, write lines, and, as, assert, break, class, continue, define, delete, else if, else, except, False, finally, for, from, global, if, import, in, is, lambda, None, non-local, not, or, pass, raise exception, return, True, try, while, with, yield, Arithmetic Error, Assertion Error, Attribute Error, Exception, End Of File Error, Floating Point Error, Generator Exit, Import Error, Indentation Error, Index Error, Key Error, Keyboard Interrupt, Lookup Error, Memory Error, Name Error, Not Implemented Error, OS Error, Overflow Error, Reference Error, Runtime Error, Stop Iteration, Syntax Error, Tab Error, System Error, System Exit, Type Error, Unbound Local Error, Unicode Error, Unicode Encode Error, Unicode Decode Error, Unicode Translate Error, Value Error, Zero Division Error

is decimal => est décimal, is digit => est chiffre, is identifier => est identificateur, is lower => est inférieur, is numeric => est numérique, is printable => est imprimable, is space => est espace, is title => est titre, is uppercase => est majuscule, join => joindre, left justify => justifier à gauche, lower => abaisser, left strip => enlever gauche, make translation => faire traduction, partition => partitionner, replace => remplacer, reverse find => trouver inverse, reverse index => index inversé, right justify => justifier à droite, right partition => partition droite, right split => diviser à droite, right strip => enlever à droite, split => séparer, split lines => séparer les lignes, starts with => commence par, strip => enlever, swap case => intervertir la casse, title => titre, translate => traduire, uppercase => majuscule, zero fill => remplir zéro, append => ajouter, clear => effacer, copy => copier, extend => étendre, insert => insérer, pop => retirer, remove => supprimer, reverse => inverser, sort => trier, from keys => à partir des clés, get => obtenir, items => éléments, keys => clés, pop item => retirer élément, set default => définir par défaut, update => mettre à jour, values => valeurs, add => ajouter, difference => différence, difference update => mettre à jour différence, discard => écarter, intersection => intersection, intersection update => mettre à jour intersection, is disjoint => est disjoint, is subset => est sous-ensemble, is superset => est sur-ensemble, symmetric difference => différence symétrique, symmetric difference update => mettre à jour différence symétrique, union => union, close => fermer, detach => détacher, file number => numéro de fichier, flush => vider, is interactive => est interactif, read => lire, readable => lisible, read line => lire ligne, read lines => lire lignes, seek => chercher, seekable => recherchable, tell => dire, truncate => tronquer, writable => inscriptible, write => écrire, write lines => écrire des lignes, and => et, as => comme, assert => affirmer, break => casser, class => classe, continue => continuer, define => définir, delete => supprimer, else if => sinon si, else => sinon, except => sauf, False => FAUX, finally => enfin, for => pour, from => à partir de, global => global, if => si, import
, right split, right strip, split, split lines, starts with, strip, swap case, title, translate, uppercase, zero fill, append, clear, copy, extend, insert, pop, remove, reverse, sort, from keys, get, items, keys, pop item, set default, update, values, add, difference, difference update, discard, intersection, intersection update, is disjoint, is subset, is superset, symmetric difference, symmetric difference update, union, close, detach, file number, flush, is interactive, read, readable, read line, read lines, seek, seekable, tell, truncate, writable, write, write lines, and, as, assert, break, class, continue, define, delete, else if, else, except, False, finally, for, from, global, if, import, in, is, lambda, None, non-local, not, or, pass, raise exception, return, True, try, while, with, yield, Arithmetic Error, Assertion Error, Attribute Error, Exception, End Of File Error, Floating Point Error, Generator Exit, Import Error, Indentation Error, Index Error, Key Error, Keyboard Interrupt, Lookup Error, Memory Error, Name Error, Not Implemented Error, OS Error, Overflow Error, Reference Error, Runtime Error, Stop Iteration, Syntax Error, Tab Error, System Error, System Exit, Type Error, Unbound Local Error, Unicode Error, Unicode Encode Error, Unicode Decode Error, Unicode Translate Error, Value Error, Zero Division Error

left justify => justifier à gauche, lower => minuscule, left strip => retirer à gauche, make translation => faire la traduction, partition => partitionner, replace => remplacer, reverse find => recherche inverse, reverse index => index inverse, right justify => justifier à droite, right partition => partition à droite, right split => diviser à droite, right strip => retirer à droite, split => couper, split lines => couper les lignes, starts with => commence par, strip => retirer, swap case => inverser les cas, title => titre, translate => traduire, uppercase => majuscule, zero fill => remplir zéro, append => ajouter, clear => effacer, copy => copier, extend => étendre, insert => insérer, pop => retirer, remove => supprimer, reverse => inverser, sort => trier, from keys => des clés, get => obtenir, items => éléments, keys => clés, pop item => retirer un élément, set default => définir par défaut, update => mettre à jour, values => valeurs, add => ajouter, difference => différence, difference update => mettre à jour la différence, discard => jeter, intersection => intersection, intersection update => mettre à jour l'intersection, is disjoint => est disjoint, is subset => est sous-ensemble, is superset => est sur-ensemble, symmetric difference => différence symétrique, symmetric difference update => mettre à jour la différence symétrique, union => union, close => fermer, detach => détacher, file number => numéro de fichier, flush => vider, is interactive => est interactif, read => lire, readable => lisible, read line => lire la ligne, read lines => lire les lignes, seek => rechercher, seekable => recherchable, tell => dire, truncate => tronquer, writable => écritable, write => écrire, write lines => écrire les lignes, and => et, as => comme, assert => affirmer, break => casser, class => classe, continue => continuer, define => définir, delete => supprimer, else if => sinon si, else => sinon, except => sauf, False => FAUX, finally => finalement, for => pour, from => à partir de, global => global, if => si, import => importer, in => dans, is => est, lambda => lambda, None => Aucun, non-local => non local, not => non, or => ou, pass => passer, raise exception => lever une exception, return => retourner, True => Vrai, try => essayer, while => pendant, with => avec, yield => rendre, Arithmetic Error => Erreur arithmétique, Assertion Error => Erreur d'assertion, Att
, zero fill

right split => divisé à droite, right strip => enlever à droite, split => diviser, split lines => diviser les lignes, starts with => commence par, strip => enlever, swap case => échanger la casse, title => titre, translate => traduire, uppercase => majuscule, zero fill => remplir de zéro.
, from keys, get, items, keys, pop item, set default, update, values, add, difference, difference update, discard, intersection, intersection update, is disjoint, is subset, is superset, symmetric difference, symmetric difference update, union, close, detach, file number, flush, is interactive, read, readable, read line, read lines, seek, seekable, tell, truncate, writable, write, write lines, and, as, assert, break, class, continue, define, delete, else if, else, except, False, finally, for, from, global, if, import, in, is, lambda, None, non-local, not, or, pass, raise exception, return, True, try, while, with, yield, Arithmetic Error, Assertion Error, Attribute Error, Exception, End Of File Error, Floating Point Error, Generator Exit, Import Error, Indentation Error, Index Error, Key Error, Keyboard Interrupt, Lookup Error, Memory Error, Name Error, Not Implemented Error, OS Error, Overflow Error, Reference Error, Runtime Error, Stop Iteration, Syntax Error, Tab Error, System Error, System Exit, Type Error, Unbound Local Error, Unicode Error, Unicode Encode Error, Unicode Decode Error, Unicode Translate Error, Value Error, Zero Division Error

zero fill => combler de zéros, append => ajouter, clear => effacer, copy => copier, extend => étendre, insert => insérer, pop => extraire, remove => supprimer, reverse => inverser, sort => trier, from keys => à partir des clés, get => obtenir, items => éléments, keys => clés, pop item => extraire un élément, set default => définir par défaut, update => mettre à jour, values => valeurs, add => ajouter, difference => différence, difference update => mettre à jour la différence, discard => rejeter, intersection => intersection, intersection update => mettre à jour l'intersection, is disjoint => est disjoint, is subset => est sous-ensemble, is superset => est un super-ensemble, symmetric difference => différence symétrique, symmetric difference update => mettre à jour la différence symétrique, union => union, close => fermer, detach => détacher, file number => numéro de fichier, flush => vider, is interactive => est interactif, read => lire, readable => lisible, read line => lire la ligne, read lines => lire les lignes, seek => chercher, seekable => recherchable, tell => dire, truncate => tronquer, writable => écrivable, write => écrire, write lines => écrire des lignes, and => et, as => comme, assert => affirmer, break => casser, class => classe, continue => continuer, define => définir, delete => supprimer, else if => sinon si, else => sinon, except => sauf, False => FAUX, finally => enfin, for => pour, from => à partir de, global => global, if => si, import => importer, in => dans, is => est, lambda => lambda, None => Aucun, non-local => non local, not => non, or => ou, pass => passer, raise exception => lever une exception, return => retourner, True => Vrai, try => essayer, while => pendant, with => avec, yield => rendre, Arithmetic Error => Erreur arithmétique, Assertion Error => Erreur d'assertion, Attribute Error => Erreur d'attribut, Exception => Exception, End Of File Error => Erreur de fin de fichier, Floating Point Error => Erreur de point flottant, Generator Exit => Sortie du générateur, Import Error => Erreur d'importation, Indentation Error => Erreur d'indentation, Index Error => Erreur d'index, Key Error => Erreur de clé, Keyboard Interrupt => Interruption clavier, Lookup Error => Erreur de recherche, Memory Error => Erreur de mémoire, Name Error => Erreur de nom, Not Implemented Error => Erreur non implémentée, OS Error => Erreur système, Overflow Error => Erreur de débordement, Reference Error => Erreur de ré
, difference update, discard, intersection, intersection update, is disjoint, is subset, is superset, symmetric difference, symmetric difference update, union, close, detach, file number, flush, is interactive, read, readable, read line, read lines, seek, seekable, tell, truncate, writable, write, write lines, and, as, assert, break, class, continue, define, delete, else if, else, except, False, finally, for, from, global, if, import, in, is, lambda, None, non-local, not, or, pass, raise exception, return, True, try, while, with, yield, Arithmetic Error, Assertion Error, Attribute Error, Exception, End Of File Error, Floating Point Error, Generator Exit, Import Error, Indentation Error, Index Error, Key Error, Keyboard Interrupt, Lookup Error, Memory Error, Name Error, Not Implemented Error, OS Error, Overflow Error, Reference Error, Runtime Error, Stop Iteration, Syntax Error, Tab Error, System Error, System Exit, Type Error, Unbound Local Error, Unicode Error, Unicode Encode Error, Unicode Decode Error, Unicode Translate Error, Value Error, Zero Division Error

From keys => à partir des clés, get => obtenir, items => articles, keys => clés, pop item => élément pop, set default => défaut défini, update => mettre à jour, values => valeurs, add => ajouter, difference => différence, difference update => mise à jour de la différence, discard => rejeter, intersection => intersection, intersection update => mise à jour de l'intersection, is disjoint => est disjoint, is subset => est sous-ensemble, is superset => est superset, symmetric difference => différence symétrique, symmetric difference update => mise à jour de la différence symétrique, union => union, close => fermer, detach => détacher, file number => numéro de fichier, flush => vider, is interactive => est interactif, read => lire, readable => lisible, read line => lire la ligne, read lines => lire les lignes, seek => chercher, seekable => recherchable, tell => dire, truncate => tronquer, writable => écritable, write => écrire, write lines => écrire des lignes, and => et, as => comme, assert => affirmer, break => rupture, class => classe, continue => continuer, define => définir, delete => supprimer, else if => sinon si, else => sinon, except => sauf, False => FAUX, finally => finalement, for => pour, from => à partir de, global => global, if => si, import => importer, in => dans, is => est, lambda => lambda, None => Aucun, non-local => non local, not => pas, or => ou, pass => passer, raise exception => lever une exception, return => retourner, True => VRAI, try => essayer, while => tandis que, with => avec, yield => rendement, Arithmetic Error => Erreur arithmétique, Assertion Error => Erreur d'assertion, Attribute Error => Erreur d'attribut, Exception => Exception, End Of File Error => Erreur de fin de fichier, Floating Point Error => Erreur de point flottant, Generator Exit => Sortie du générateur, Import Error => Erreur d'importation, Indentation Error => Erreur d'indentation, Index Error => Erreur d'index, Key Error => Erreur de clé, Keyboard Interrupt => Interruption clavier, Lookup Error => Erreur de recherche, Memory Error => Erreur de mémoire, Name Error => Erreur de nom, Not Implemented Error => Erreur non implémentée, OS Error => Erreur du système d'exploitation, Overflow Error => Erreur de dépassement, Reference Error => Erreur de référence, Runtime Error => Erreur de temps d'exécution, Stop Iteration => Arrêter l'itération, Syntax Error => Erreur de syntaxe, Tab Error => Erreur de tabulation, System Error => Erreur système, System Exit => Sortie du système, Type Error => Erreur de


difference update => mise à jour de la différence, discard => rejeter, intersection => intersection, intersection update => mise à jour de l'intersection, is disjoint => est disjoint, is subset => est sous-ensemble, is superset => est un ensemble plus grand, symmetric difference => différence symétrique, symmetric difference update => mise à jour de la différence symétrique, union => union.
, seekable, tell, truncate, writable, write, write lines,

Fermer, détacher, numéro de fichier, vider, est interactif, lire, lisible, lire la ligne, lire les lignes, chercher, recherchable, dire, tronquer, écriture, écrire, écrire des lignes.
, class, continue, define, delete, else if, else, except, False, finally, for, from, global, if, import, in, is, lambda, None, non-local, not, or, pass, raise exception, return, True, try, while, with, yield, Arithmetic Error, Assertion Error, Attribute Error, Exception, End Of File Error, Floating Point Error, Generator Exit, Import Error, Indentation Error, Index Error, Key Error, Keyboard Interrupt, Lookup Error, Memory Error, Name Error, Not Implemented Error, OS Error, Overflow Error, Reference Error, Runtime Error, Stop Iteration, Syntax Error, Tab Error, System Error, System Exit, Type Error, Unbound Local Error, Unicode Error, Unicode Encode Error, Unicode Decode Error, Unicode Translate Error, Value Error, Zero Division Error

seekable => recherchable, tell => dire, truncate => tronquer, writable => inscriptible, write => écrire, write lines => écrire des lignes, and => et, as => comme, assert => affirmer, break => casser, class => classe, continue => continuer, define => définir, delete => supprimer, else if => sinon si, else => sinon, except => excepté, False => FAUX, finally => finalement, for => pour, from => à partir de, global => global, if => si, import => importer, in => dans, is => est, lambda => lambda, None => Aucun, non-local => non local, not => pas, or => ou, pass => passer, raise exception => lever une exception, return => retourner, True => VRAI, try => essayer, while => pendant, with => avec, yield => produire, Arithmetic Error => Erreur arithmétique, Assertion Error => Erreur d'assertion, Attribute Error => Erreur d'attribut, Exception => Exception, End Of File Error => Erreur de fin de fichier, Floating Point Error => Erreur de point flottant, Generator Exit => Sortie du générateur, Import Error => Erreur d'importation, Indentation Error => Erreur d'indentation, Index Error => Erreur d'index, Key Error => Erreur de clé, Keyboard Interrupt => Interruption du clavier, Lookup Error => Erreur de recherche, Memory Error => Erreur de mémoire, Name Error => Erreur de nom, Not Implemented Error => Erreur non implémentée, OS Error => Erreur du système d'exploitation, Overflow Error => Erreur de débordement, Reference Error => Erreur de référence, Runtime Error => Erreur de temps d'exécution, Stop Iteration => Arrêter l'itération, Syntax Error => Erreur de syntaxe, Tab Error => Erreur de tabulation, System Error => Erreur système, System Exit => Sortie du système, Type Error => Erreur de type, Unbound Local Error => Erreur locale non liée, Unicode Error => Erreur Unicode, Unicode Encode Error => Erreur d'encodage Unicode, Unicode Decode Error => Erreur de décodage Unicode, Unicode Translate Error => Erreur de traduction Unicode, Value Error => Erreur de valeur, Zero Division Error => Erreur de division par zéro.
, from, global, if, import, in, is, lambda, None, non-local, not, or, pass, raise exception, return, True, try, while, with, yield, Arithmetic Error, Assertion Error, Attribute Error, Exception, End Of File Error, Floating Point Error, Generator Exit, Import Error, Indentation Error, Index Error, Key Error, Keyboard Interrupt, Lookup Error, Memory Error, Name Error, Not Implemented Error, OS Error, Overflow Error, Reference Error, Runtime Error, Stop Iteration, Syntax Error, Tab Error, System Error, System Exit, Type Error, Unbound Local Error, Unicode Error, Unicode Encode Error, Unicode Decode Error, Unicode Translate Error, Value Error, Zero Division Error

Classe, continuer, définir, supprimer, sinon si, sinon, sauf, faux, finalement, pour, de, global, si, importer, dans, est, lambda, aucun, non local, non, ou, passer, lever une exception, retourner, vrai, essayer, tandis que, avec, rendement, erreur arithmétique, erreur d'assertion, erreur d'attribut, exception, erreur de fin de fichier, erreur de point flottant, sortie du générateur, erreur d'importation, erreur d'indentation, erreur d'index, erreur de clé, interruption du clavier, erreur de recherche, erreur de mémoire, erreur de nom, erreur non implémentée, erreur du système d'exploitation, erreur de débordement, erreur de référence, erreur de temps d'exécution, arrêter l'itération, erreur de syntaxe, erreur de tabulation, erreur système, sortie système, erreur de type, erreur locale non liée, erreur Unicode, erreur d'encodage Unicode, erreur de décodage Unicode, erreur de traduction Unicode, erreur de valeur, erreur de division par zéro.
, or, pass, raise exception, return, True, try, while, with, yield, Arithmetic Error, Assertion Error, Attribute Error, Exception, End Of File Error, Floating Point Error, Generator Exit, Import Error, Indentation Error, Index Error, Key Error, Keyboard Interrupt, Lookup Error, Memory Error, Name Error, Not Implemented Error, OS Error, Overflow Error, Reference Error, Runtime Error, Stop Iteration, Syntax Error, Tab Error, System Error, System Exit, Type Error, Unbound Local Error, Unicode Error, Unicode Encode Error, Unicode Decode Error, Unicode Translate Error, Value Error, Zero Division Error

de, global, si, importer, dans, est, lambda, Aucun, non local, non, ou, passer, lever une exception, retourner, Vrai, essayer, tandis que, avec, rendement, Erreur arithmétique, Erreur d'assertion, Erreur d'attribut, Exception, Fin d'erreur de fichier, Erreur de point flottant, Sortie du générateur, Erreur d'importation, Erreur d'indentation, Erreur d'index, Erreur de clé, Interruption clavier, Erreur de recherche, Erreur de mémoire, Erreur de nom, Erreur non implémentée, Erreur OS, Erreur de débordement, Erreur de référence, Erreur de temps d'exécution, Arrêter l'itération, Erreur de syntaxe, Erreur d'onglet, Erreur système, Sortie système, Erreur de type, Erreur locale non liée, Erreur Unicode, Erreur de codage Unicode, Erreur de décodage Unicode, Erreur de traduction Unicode, Erreur de valeur, Erreur de division zéro.
, Assertion Error, Attribute Error, Exception, End Of File Error, Floating Point Error, Generator Exit, Import Error, Indentation Error, Index Error, Key Error, Keyboard Interrupt, Lookup Error, Memory Error, Name Error, Not Implemented Error, OS Error, Overflow Error, Reference Error, Runtime Error, Stop Iteration, Syntax Error, Tab Error, System Error, System Exit, Type Error, Unbound Local Error, Unicode Error, Unicode Encode Error, Unicode Decode Error, Unicode Translate Error, Value Error, Zero Division Error

or => ou, pass => passer, raise exception => lever une exception, return => retourner, True => Vrai, try => essayer, while => tandis que, with => avec, yield => rendement, Arithmetic Error => Erreur arithmétique, Assertion Error => Erreur d'assertion, Attribute Error => Erreur d'attribut, Exception => Exception, End Of File Error => Erreur de fin de fichier, Floating Point Error => Erreur de point flottant, Generator Exit => Sortie du générateur, Import Error => Erreur d'importation, Indentation Error => Erreur d'indentation, Index Error => Erreur d'index, Key Error => Erreur de clé, Keyboard Interrupt => Interruption clavier, Lookup Error => Erreur de recherche, Memory Error => Erreur de mémoire, Name Error => Erreur de nom, Not Implemented Error => Erreur non implémentée, OS Error => Erreur du système d'exploitation, Overflow Error => Erreur de débordement, Reference Error => Erreur de référence, Runtime Error => Erreur de temps d'exécution, Stop Iteration => Arrêter l'itération, Syntax Error => Erreur de syntaxe, Tab Error => Erreur de tabulation, System Error => Erreur système, System Exit => Sortie du système, Type Error => Erreur de type, Unbound Local Error => Erreur locale non liée, Unicode Error => Erreur Unicode, Unicode Encode Error => Erreur d'encodage Unicode, Unicode Decode Error => Erreur de décodage Unicode, Unicode Translate Error => Erreur de traduction Unicode, Value Error => Erreur de valeur, Zero Division Error => Erreur de division par zéro.
, Keyboard Interrupt, Lookup Error, Memory Error, Name Error, Not Implemented Error, OS Error, Overflow Error, Reference Error, Runtime Error, Stop Iteration, Syntax Error, Tab Error, System Error, System Exit, Type Error, Unbound Local Error, Unicode Error, Unicode Encode Error, Unicode Decode Error, Unicode Translate Error, Value Error, Zero Division Error

Erreur d'assertion, Erreur d'attribut, Exception, Erreur de fin de fichier, Erreur de point flottant, Sortie du générateur, Erreur d'importation, Erreur d'indentation, Erreur d'index, Erreur de clé, Interruption clavier, Erreur de recherche, Erreur de mémoire, Erreur de nom, Erreur non implémentée, Erreur système, Erreur de débordement, Erreur de référence, Erreur de temps d'exécution, Arrêt de l'itération, Erreur de syntaxe, Erreur de tabulation, Erreur système, Sortie système, Erreur de type, Erreur locale non liée, Erreur Unicode, Erreur d'encodage Unicode, Erreur de décodage Unicode, Erreur de traduction Unicode, Erreur de valeur, Erreur de division par zéro.
, Syntax Error, Tab Error, System Error, System Exit, Type Error, Unbound Local Error, Unicode Error, Unicode Encode Error, Unicode Decode Error, Unicode Translate Error, Value Error, Zero Division Error

Interruption clavier, Erreur de recherche, Erreur de mémoire, Erreur de nom, Erreur non implémentée, Erreur OS, Erreur de débordement, Erreur de référence, Erreur de temps d'exécution, Arrêt de l'itération, Erreur de syntaxe, Erreur de tabulation, Erreur système, Sortie système, Erreur de type, Erreur locale non liée, Erreur Unicode, Erreur d'encodage Unicode, Erreur de décodage Unicode, Erreur de traduction Unicode, Erreur de valeur, Erreur de division zéro.
, Value Error, Zero Division Error.

Erreur de syntaxe, Erreur de tabulation, Erreur système, Sortie système, Erreur de type, Erreur locale non liée, Erreur Unicode, Erreur d'encodage Unicode, Erreur de décodage Unicode, Erreur de traduction Unicode, Erreur de valeur, Erreur de division par zéro.
