, class method, compile, complex, delete attribute, dictionary, directory, divide modulus, enumerate, evaluate, execute, filter, floating point, format, frozen set, get attribute, globals, has attribute, hash, help, hexadecimal, identity, input, integer, is instance, is subclass, iterator, length, list, locals, map, maximum, memory view, minimum, next, object, octal, open, ordinal, power, print, property, range, represent, reversed, round, set, set attribute, slice, sorted, static method, string, summation, superset, tuple, type, variables, zip, capitalize, case fold, center, count, encode, ends with, expand tabs, find, format map, index, is alphanumeric, is alphabetic, is ascii, is decimal, is digit, is identifier, is lower, is numeric, is printable, is space, is title, is uppercase, join, left justify, lower, left strip, make translation, partition, replace, reverse find, reverse index, right justify, right partition, right split, right strip, split, split lines, starts with, strip, swap case, title, translate, uppercase, zero fill, append, clear, copy, extend, insert, pop, remove, reverse, sort, from keys, get, items, keys, pop item, set default, update, values, add, difference, difference update, discard, intersection, intersection update, is disjoint, is subset, is superset, symmetric difference, symmetric difference update, union, close, detach, file number, flush, is interactive, read, readable, read line, read lines, seek, seekable, tell, truncate, writable, write, write lines, and, as, assert, break, class, continue, define, delete, else if, else, except, False, finally, for, from, global, if, import, in, is, lambda, None, non-local, not, or, pass, raise exception, return, True, try, while, with, yield, Arithmetic Error, Assertion Error, Attribute Error, Exception, End Of File Error, Floating Point Error, Generator Exit, Import Error, Indentation Error, Index Error, Key Error, Keyboard Interrupt, Lookup Error, Memory Error, Name Error, Not Implemented Error, OS Error, Overflow Error, Reference Error, Runtime Error, Stop Iteration, Syntax Error, Tab Error, System Error, System Exit, Type Error, Unbound Local Error, Unicode Error, Unicode Encode Error, Unicode Decode Error, Unicode Translate Error, Value Error, Zero Division Error

Absolute Value => निर्धारित मूल्य, All => सब, Any => कोई, ASCII => एस्की, Binary => द्वितीय, Boolean => बूलियन, Byte Array => बाइट अरे, Bytes => बाइट्स, Callable => कॉलेबल, Character => चरित्र, Class Method => क्लास विधि, Compile => संकलन, Complex => जटिल, Delete Attribute => विशेषता हटाएं, Dictionary => शब्दकोश, Directory => निर्देशिका, Divide Modulus => भाग अंतर, Enumerate => सूचीबद्ध करें, Evaluate => मूल्यांकन, Execute => निष्पादित करें, Filter => फ़िल्टर, Floating Point => फ्लोटिंग पॉइंट, Format => स्वरूप, Frozen Set => जमी सेट, Get Attribute => व
, filter, floating point, format, frozen set, get attribute, globals, has attribute, hash, help, hexadecimal, identity, input, integer, is instance, is subclass, iterator, length, list, locals, map, maximum, memory view, minimum, next, object, octal, open, ordinal, power, print, property, range, represent, reversed, round, set, set attribute, slice, sorted, static method, string, summation, superset, tuple, type, variables, zip

क्लास मेथड, कंपाइल, कॉम्प्लेक्स, विशेषता हटाएं, डिक्शनरी, निर्देशिका, भागन मॉड्यूलस, सूचीबद्ध करें, मूल्यांकन करें, निष्पादित करें, फिल्टर करें, फ्लोटिंग पॉइंट, ढांचा, जमी हुई सेट, विशेषता प्राप्त करें, वैश्विक, विशेषता है, हैश, मदद, हेक्साडेसिमल, पहचान, इनपुट, पूर्णांक, उदाहरण है, उपसर्ग है, इटरेटर, लंबाई, सूची, स्थानीय, मैप, अधिकतम, मेमोरी व्यू, न्यूनतम, अगला, वस्तु, अष्टिक्रमीय, खोलें, अनुक्रमीय, शक्ति, प्रिंट, गुण, सीमा, प्रतिनिधित्व करें, उलटा हुआ, गोल, सेट, विशेषता सेट करें, तड़का, क्रमित, स्थिर मेथड, स्ट्रिंग, योग, सुपरसेट, ट्यूपल, प्रकार, चर, ज़िप
, identity, input, integer, is instance, is subclass, iterator, length, list, locals, map, maximum, memory view, minimum, next, object, octal, open, ordinal, power, print, property, range, represent, reversed, round, set, set attribute, slice, sorted, static method, string, summation, superset, tuple, type, variables, zip, capitalize, case fold, center, count, encode, ends with, expand tabs, find, format map, index, is alphanumeric, is alphabetic, is ascii, is decimal, is digit, is identifier, is lower, is numeric, is printable, is space, is title, is uppercase, join, left justify, lower, left strip, make translation, partition, replace, reverse find, reverse index, right justify, right partition, right split, right strip, split, split lines, starts with, strip, swap case, title, translate, uppercase, zero fill, append, clear, copy, extend, insert, pop, remove, reverse, sort, from keys, get, items, keys, pop item, set default, update, values, add, difference, difference update, discard, intersection, intersection update, is disjoint, is subset, is superset, symmetric difference, symmetric difference update, union, close, detach, file number, flush, is interactive, read, readable, read line, read lines, seek, seekable, tell, truncate, writable, write, write lines, and, as, assert, break, class, continue, define, delete, else if, else, except, False, finally, for, from, global, if, import, in, is, lambda, None, non-local, not, or, pass, raise exception, return, True, try, while, with, yield, Arithmetic Error, Assertion Error, Attribute Error, Exception, End Of File Error, Floating Point Error, Generator Exit, Import Error, Indentation Error, Index Error, Key Error, Keyboard Interrupt, Lookup Error, Memory Error, Name Error, Not Implemented Error, OS Error, Overflow Error, Reference Error, Runtime Error, Stop Iteration, Syntax Error, Tab Error, System Error, System Exit, Type Error, Unbound Local Error, Unicode Error, Unicode Encode Error, Unicode Decode Error, Unicode Translate Error, Value Error, Zero Division Error

फ़िल्टर, स्वरूपण बिंदु, स्वरूप, जमीनी सेट, गुण प्राप्त करें, वैश्विक, गुण है, हैश, सहायता, अष्टिकोडिकल, पहचान, इनपुट, पूर्णांक, प्रतिलिपि है, उपकरण है, इटरेटर, लंबाई, सूची, स्थानीय, मानचित्र, अधिकतम, मेमोरी व्यू, न्यूनतम, अगला, वस्तु, अष्टिकालीन, खोलें, क्रमांक, शक्ति, मुद्रण, गुणधर्म, श्रेणी, प्रतिनिधित्व, पुनर्
, maximum, memory view, minimum, next, object, octal, open, ordinal, power, print, property, range, represent, reversed, round, set, set attribute, slice, sorted, static method, string, summation, superset, tuple, type, variables, zip, capitalize, case fold, center, count, encode, ends with, expand tabs, find, format map, index, is alphanumeric, is alphabetic, is ascii, is decimal, is digit, is identifier, is lower, is numeric, is printable, is space, is title, is uppercase, join, left justify, lower, left strip, make translation, partition, replace, reverse find, reverse index, right justify, right partition, right split, right strip, split, split lines, starts with, strip, swap case, title, translate, uppercase, zero fill, append, clear, copy, extend, insert, pop, remove, reverse, sort, from keys, get, items, keys, pop item, set default, update, values, add, difference, difference update, discard, intersection, intersection update, is disjoint, is subset, is superset, symmetric difference, symmetric difference update, union, close, detach, file number, flush, is interactive, read, readable, read line, read lines, seek, seekable, tell, truncate, writable, write, write lines, and, as, assert, break, class, continue, define, delete, else if, else, except, False, finally, for, from, global, if, import, in, is, lambda, None, non-local, not, or, pass, raise exception, return, True, try, while, with, yield, Arithmetic Error, Assertion Error, Attribute Error, Exception, End Of File Error, Floating Point Error, Generator Exit, Import Error, Indentation Error, Index Error, Key Error, Keyboard Interrupt, Lookup Error, Memory Error, Name Error, Not Implemented Error, OS Error, Overflow Error, Reference Error, Runtime Error, Stop Iteration, Syntax Error, Tab Error, System Error, System Exit, Type Error, Unbound Local Error, Unicode Error, Unicode Encode Error, Unicode Decode Error, Unicode Translate Error, Value Error, Zero Division Error

पहचान, इनपुट, पूर्णांक, है नमूना, है उप-वर्ग, इटरेटर, लंबाई, सूची, स्थानीय, नक्शा, अधिकतम, मेमोरी व्यू, न्यूनतम, अगला, वस्तु, आठवीं आधार, खोलना, क्रमीक, शक्ति, प्रिंट, गुण, रेंज, प्रतिनिधित्व, उलटा हुआ, गेंद, सेट, सेट गुण, कटौती, क्रमित, स्थायी विधि, स्ट्रिंग, योग, सुपरसेट, ट्यूपल, प्रकार, चर, ज़िप, कैपिटलाइज़, केस फोल्ड, केंद्र, गिनती,
, property, range, represent, reversed, round, set, set attribute, slice, sorted, static method, string, summation, superset, tuple, type, variables, zip, capitalize, case fold, center, count, encode, ends with, expand tabs, find, format map, index, is alphanumeric, is alphabetic, is ascii, is decimal, is digit, is identifier, is lower, is numeric, is printable, is space, is title, is uppercase, join, left justify, lower, left strip, make translation, partition, replace, reverse find, reverse index, right justify, right partition, right split, right strip, split, split lines, starts with, strip, swap case, title, translate, uppercase, zero fill, append, clear, copy, extend, insert, pop, remove, reverse, sort, from keys, get, items, keys, pop item, set default, update, values, add, difference, difference update, discard, intersection, intersection update, is disjoint, is subset, is superset, symmetric difference, symmetric difference update, union, close, detach, file number, flush, is interactive, read, readable, read line, read lines, seek, seekable, tell, truncate, writable, write, write lines, and, as, assert, break, class, continue, define, delete, else if, else, except, False, finally, for, from, global, if, import, in, is, lambda, None, non-local, not, or, pass, raise exception, return, True, try, while, with, yield, Arithmetic Error, Assertion Error, Attribute Error, Exception, End Of File Error, Floating Point Error, Generator Exit, Import Error, Indentation Error, Index Error, Key Error, Keyboard Interrupt, Lookup Error, Memory Error, Name Error, Not Implemented Error, OS Error, Overflow Error, Reference Error, Runtime Error, Stop Iteration, Syntax Error, Tab Error, System Error, System Exit, Type Error, Unbound Local Error, Unicode Error, Unicode Encode Error, Unicode Decode Error, Unicode Translate Error, Value Error, Zero Division Error

Maximum => अधिकतम
Memory View => मेमोरी व्यू
Minimum => न्यूनतम
Next => अगला
Object => वस्तु
Octal => अष्टमीक
Open => खुला
Ordinal => क्रमानुसार
Power => शक्ति
Print => प्रिंट
Property => गुणधर्म
Range => रेंज
Represent => प्रतिनिधित्व
Reversed => उलटा
Round => गोल
Set => सेट
Set Attribute => गुणधर्म सेट करें
Slice => टुकड़ा
Sorted => क्रमबद्ध
Static Method => स्थिर विधि
String => स्ट्रिंग
Summation => योग
Superset => सुपरसेट
Tuple => ट्यूपल
Type => प्रकार
Variables => चर
Zip => ज़िप
Capitalize => कैपिटलाइज
Case Fold => केस फोल्ड
Center => केंद्र
Count => गणना
Encode => एन्कोड
Ends With => से समाप्त होता है
Expand Tabs =>
, string, summation, superset, tuple, type, variables, zip, capitalize, case fold, center, count, encode, ends with, expand tabs, find, format map, index, is alphanumeric, is alphabetic, is ascii, is decimal, is digit, is identifier, is lower, is numeric, is printable, is space, is title, is uppercase, join, left justify, lower, left strip, make translation, partition, replace, reverse find, reverse index, right justify, right partition, right split, right strip, split, split lines, starts with, strip, swap case, title, translate, uppercase, zero fill, append, clear, copy, extend, insert, pop, remove, reverse, sort, from keys, get, items, keys, pop item, set default, update, values, add, difference, difference update, discard, intersection, intersection update, is disjoint, is subset, is superset, symmetric difference, symmetric difference update, union, close, detach, file number, flush, is interactive, read, readable, read line, read lines, seek, seekable, tell, truncate, writable, write, write lines, and, as, assert, break, class, continue, define, delete, else if, else, except, False, finally, for, from, global, if, import, in, is, lambda, None, non-local, not, or, pass, raise exception, return, True, try, while, with, yield, Arithmetic Error, Assertion Error, Attribute Error, Exception, End Of File Error, Floating Point Error, Generator Exit, Import Error, Indentation Error, Index Error, Key Error, Keyboard Interrupt, Lookup Error, Memory Error, Name Error, Not Implemented Error, OS Error, Overflow Error, Reference Error, Runtime Error, Stop Iteration, Syntax Error, Tab Error, System Error, System Exit, Type Error, Unbound Local Error, Unicode Error, Unicode Encode Error, Unicode Decode Error, Unicode Translate Error, Value Error, Zero Division Error

Property => गुण, Range => सीमा, Represent => प्रतिनिधित्व करें, Reversed => उलटा, Round => गोल, Set => सेट, Set Attribute => गुण सेट करें, Slice => कटाई, Sorted => क्रमबद्ध, Static Method => स्थिर विधि, String => स्ट्रिंग, Summation => योग, Superset => सुपरसेट, Tuple => चतुर्भुज, Type => प्रकार, Variables => चर, Zip => ज़िप, Capitalize => शीर्षक, Case Fold => केस फोल्ड, Center => केंद्र, Count => गणना करें, Encode => एन्कोड करें, Ends With => के साथ समाप्त होता है, Expand Tabs => टैब विस्तार करें, Find => खोजें, Format Map => प्रारूप मानचित्र, Index => सूचकांक, Is Alphanumeric => अल्फान्युमेरिक है, Is Alphanumeric => अल्फाबेटिक है, Is Ascii => एस्की है
, count, encode, ends with, expand tabs, find, format map, index, is alphanumeric, is alphabetic, is ascii, is decimal, is digit, is identifier, is lower, is numeric, is printable, is space, is title, is uppercase, join, left justify, lower, left strip, make translation, partition, replace, reverse find, reverse index, right justify, right partition, right split, right strip, split, split lines, starts with, strip, swap case, title, translate, uppercase, zero fill, append, clear, copy, extend, insert, pop, remove, reverse, sort, from keys, get, items, keys, pop item, set default, update, values, add, difference, difference update, discard, intersection, intersection update, is disjoint, is subset, is superset, symmetric difference, symmetric difference update, union, close, detach, file number, flush, is interactive, read, readable, read line, read lines, seek, seekable, tell, truncate, writable, write, write lines, and, as, assert, break, class, continue, define, delete, else if, else, except, False, finally, for, from, global, if, import, in, is, lambda, None, non-local, not, or, pass, raise exception, return, True, try, while, with, yield, Arithmetic Error, Assertion Error, Attribute Error, Exception, End Of File Error, Floating Point Error, Generator Exit, Import Error, Indentation Error, Index Error, Key Error, Keyboard Interrupt, Lookup Error, Memory Error, Name Error, Not Implemented Error, OS Error, Overflow Error, Reference Error, Runtime Error, Stop Iteration, Syntax Error, Tab Error, System Error, System Exit, Type Error, Unbound Local Error, Unicode Error, Unicode Encode Error, Unicode Decode Error, Unicode Translate Error, Value Error, Zero Division Error

स्ट्रिंग, योग, सुपरसेट, ट्यूपल, प्रकार, चर, ज़िप, कैपिटलाइज, केस फोल्ड, सेंटर, गिनती, एन्कोड, एंड्स विथ, एक्स्पांड टैब्स, ढूँढ़ें, फॉर्मेट मैप, सूचकांक, आयामी अक्षरों में है, अक्षरों में है, एसकीआई है, दशमलव है, अंक है, आईडेंटिफायर है, निचला है, सांख्यिक है, मुद्रित योग्य है, अंतराल है, शीर्षक है, अपरकेस है, जोड़ें, बाएँ संयोजित करें, निचला, बाएँ पार्श्वचित्र, अनुवाद बनाएं, भा
, is decimal, is digit, is identifier, is lower, is numeric, is printable, is space, is title, is uppercase, join, left justify, lower, left strip, make translation, partition, replace, reverse find, reverse index, right justify, right partition, right split, right strip, split, split lines, starts with, strip, swap case, title, translate, uppercase, zero fill, append, clear, copy, extend, insert, pop, remove, reverse, sort, from keys, get, items, keys, pop item, set default, update, values, add, difference, difference update, discard, intersection, intersection update, is disjoint, is subset, is superset, symmetric difference, symmetric difference update, union, close, detach, file number, flush, is interactive, read, readable, read line, read lines, seek, seekable, tell, truncate, writable, write, write lines, and, as, assert, break, class, continue, define, delete, else if, else, except, False, finally, for, from, global, if, import, in, is, lambda, None, non-local, not, or, pass, raise exception, return, True, try, while, with, yield, Arithmetic Error, Assertion Error, Attribute Error, Exception, End Of File Error, Floating Point Error, Generator Exit, Import Error, Indentation Error, Index Error, Key Error, Keyboard Interrupt, Lookup Error, Memory Error, Name Error, Not Implemented Error, OS Error, Overflow Error, Reference Error, Runtime Error, Stop Iteration, Syntax Error, Tab Error, System Error, System Exit, Type Error, Unbound Local Error, Unicode Error, Unicode Encode Error, Unicode Decode Error, Unicode Translate Error, Value Error, Zero Division Error

गिनती, एन्कोड, के साथ समाप्त, टैब्स विस्तार, ढूंढो, प्रारूप मानचित्र, सूचकांक, अल्फान्यूमेरिक, अल्फाबेटिक, अस्की, दशमलव, अंक, पहचानकर्ता, निचला, संख्यात्मक, मुद्रित करने योग्य, रिक्त स्थान, शीर्षक है, मैयूसकेस, मिलाओ, बाएं तर्जुरी, निम्न, बाएं छींटो, अनुवाद बनाओ, विभाजन, बदलें, उलटी ढूंढें, उलटी सूचकांक, दाएं तर्जुरी, दाएं विभाजन, दाएं विभाजन, दाएं छींटो, विभाजित, लाइनों को विभाजित करें, शुरू करत
, left justify, lower, left strip, make translation, partition, replace, reverse find, reverse index, right justify, right partition, right split, right strip, split, split lines, starts with, strip, swap case, title, translate, uppercase, zero fill, append, clear, copy, extend, insert, pop, remove, reverse, sort, from keys, get, items, keys, pop item, set default, update, values, add, difference, difference update, discard, intersection, intersection update, is disjoint, is subset, is superset, symmetric difference, symmetric difference update, union, close, detach, file number, flush, is interactive, read, readable, read line, read lines, seek, seekable, tell, truncate, writable, write, write lines, and, as, assert, break, class, continue, define, delete, else if, else, except, False, finally, for, from, global, if, import, in, is, lambda, None, non-local, not, or, pass, raise exception, return, True, try, while, with, yield, Arithmetic Error, Assertion Error, Attribute Error, Exception, End Of File Error, Floating Point Error, Generator Exit, Import Error, Indentation Error, Index Error, Key Error, Keyboard Interrupt, Lookup Error, Memory Error, Name Error, Not Implemented Error, OS Error, Overflow Error, Reference Error, Runtime Error, Stop Iteration, Syntax Error, Tab Error, System Error, System Exit, Type Error, Unbound Local Error, Unicode Error, Unicode Encode Error, Unicode Decode Error, Unicode Translate Error, Value Error, Zero Division Error

स्पष्ट है, डिजिट, आईडेंटीफायर, नीचे, संख्यात्मक, छपाई योग्य, स्थान, शीर्षक, अपरकेड, शामिल, बाएं समायोजित, नीचे, छोड़ें, बनाएं अनुवाद, विभाजन, बदलें, उलटी खोज, उलटी सूचकांक, दाएं समायोजित, दाएं विभाजन, दाएं विभाजन, दाएं छोड़ें, विभाजित, लाइनों को विभाजित, शुरू होता है, छोड़ें, विलोम, मुद्रा बदलें, शीर्षक, अनुवाद, अपरकेड, शून्य भरें, जोड़ें, साफ़, कॉपी, बढ़ाएं, सम्मिलित करें, पॉप, हटाएं, उलटें, क्रमबद्ध, कुंजी से, पर प्राप
, right split, right strip, split, split lines, starts with, strip, swap case, title, translate, uppercase, zero fill, append, clear, copy, extend, insert, pop, remove, reverse, sort, from keys, get, items, keys, pop item, set default, update, values, add, difference, difference update, discard, intersection, intersection update, is disjoint, is subset, is superset, symmetric difference, symmetric difference update, union, close, detach, file number, flush, is interactive, read, readable, read line, read lines, seek, seekable, tell, truncate, writable, write, write lines, and, as, assert, break, class, continue, define, delete, else if, else, except, False, finally, for, from, global, if, import, in, is, lambda, None, non-local, not, or, pass, raise exception, return, True, try, while, with, yield, Arithmetic Error, Assertion Error, Attribute Error, Exception, End Of File Error, Floating Point Error, Generator Exit, Import Error, Indentation Error, Index Error, Key Error, Keyboard Interrupt, Lookup Error, Memory Error, Name Error, Not Implemented Error, OS Error, Overflow Error, Reference Error, Runtime Error, Stop Iteration, Syntax Error, Tab Error, System Error, System Exit, Type Error, Unbound Local Error, Unicode Error, Unicode Encode Error, Unicode Decode Error, Unicode Translate Error, Value Error, Zero Division Error

बाएं जस्टीफाई, निचला, बाएं स्ट्रिप, अनुवाद बनाएँ, विभाजन, बदलें, उलटी ढूँढें, उलटी सूचकांक, दाएं जस्टीफाई, दाएं विभाजन, दाएं विभाजन, दाएं स्ट्रिप, विभाजित, लाइनों को विभाजित, शुरू होता है, स्ट्रिप, स्वैप केस, शीर्षक, अनुवाद, ऊपरी केस, शून्य भरें, जोड़ें, साफ़, प्रतिलिपि, विस्तार, सम्मिलित, हटाएँ, उलटे, क्रमबद्ध, कुंजी से, आइटम, कुंजी, आइटम हटाएँ, डिफ़ॉल्ट सेट करें, अद्यतन, मान, जोड़ें, अंतर, अंतर अपडेट, त्याग, अंतर्गत, अंतर्गत अपडेट, अस
, zero fill, append, clear, copy, extend, insert, pop, remove, reverse, sort, from keys, get, items, keys, pop item, set default, update, values, add, difference, difference update, discard, intersection, intersection update, is disjoint, is subset, is superset, symmetric difference, symmetric difference update, union, close, detach, file number, flush, is interactive, read, readable, read line, read lines, seek, seekable, tell, truncate, writable, write, write lines, and, as, assert, break, class, continue, define, delete, else if, else, except, False, finally, for, from, global, if, import, in, is, lambda, None, non-local, not, or, pass, raise exception, return, True, try, while, with, yield, Arithmetic Error, Assertion Error, Attribute Error, Exception, End Of File Error, Floating Point Error, Generator Exit, Import Error, Indentation Error, Index Error, Key Error, Keyboard Interrupt, Lookup Error, Memory Error, Name Error, Not Implemented Error, OS Error, Overflow Error, Reference Error, Runtime Error, Stop Iteration, Syntax Error, Tab Error, System Error, System Exit, Type Error, Unbound Local Error, Unicode Error, Unicode Encode Error, Unicode Decode Error, Unicode Translate Error, Value Error, Zero Division Error

right split => सही विभाजन, right strip => सही छिपाना, split => विभाजित, split lines => पंक्तियों को विभाजित करें, starts with => से शुरू होता है, strip => छिपाना, swap case => केस बदलें, title => शीर्षक, translate => अनुवाद करें, uppercase => अपरकेस, zero fill => शून्य भरें, append => जोड़ें, clear => साफ, copy => प्रतिलिपि, extend => बढ़ाएँ, insert => सम्मिलित करें, pop => हटाएँ, remove => हटाएँ, reverse => उलटें, sort => क्रमबद्ध करें, from keys => कुंजियों से, get => प्राप्त करें, items => आइटम, keys => कुंजी, pop item => आइटम हटाएँ, set default => डिफ़ॉल्ट सेट करें, update => अपडेट करें, values => मान, add => जोड़ें, difference => अंतर, difference update => अंतर अपडेट करें, discard => खारिज करें, intersection => आंशिक मेल, intersection update => आंशिक मेल अपडेट करें, is disjoint => अलग है, is subset => सबसेट है
, from keys, get, items, keys, pop item, set default, update, values, add, difference, difference update, discard, intersection, intersection update, is disjoint, is subset, is superset, symmetric difference, symmetric difference update, union, close, detach, file number, flush, is interactive, read, readable, read line, read lines, seek, seekable, tell, truncate, writable, write, write lines, and, as, assert, break, class, continue, define, delete, else if, else, except, False, finally, for, from, global, if, import, in, is, lambda, None, non-local, not, or, pass, raise exception, return, True, try, while, with, yield, Arithmetic Error, Assertion Error, Attribute Error, Exception, End Of File Error, Floating Point Error, Generator Exit, Import Error, Indentation Error, Index Error, Key Error, Keyboard Interrupt, Lookup Error, Memory Error, Name Error, Not Implemented Error, OS Error, Overflow Error, Reference Error, Runtime Error, Stop Iteration, Syntax Error, Tab Error, System Error, System Exit, Type Error, Unbound Local Error, Unicode Error, Unicode Encode Error, Unicode Decode Error, Unicode Translate Error, Value Error, Zero Division Error

Zero fill => शून्य भरें, Append => जोड़ें, Clear => साफ़ करें, Copy => कॉपी करें, Extend => विस्तार करें, Insert => डालें, Pop => हटाएं, Remove => हटाएं, Reverse => उलटें, Sort => क्रमबद्ध करें, From Keys => कुंजियों से, Get => प्राप्त करें, Items => आइटम, Keys => कुंजी, Pop Item => आइटम हटाएं, Set Default => डिफ़ॉल्ट सेट करें, Update => अपडेट करें, Values => मान, Add => जोड़ें, Difference => अंतर, Difference Update => अंतर अपडेट करें, Discard => छोड़ दें, Intersection => आंशिक मेल, Intersection Update => आंशिक मेल अपडेट करें, Is Disjoint => अलग है, Is Subset => उपसमूह है, Is Superset => सुपरसेट है, Symmetric Difference => समक्ष अंतर, Symmetric Difference Update => समक्ष अंतर अपडेट करें, Union => संयुक्त, Close => बंद करें, Detach => अलग करें, File Number => फ़ाइल संख्या, Flush => फ्लश करें, Is Interactive => इंटरैक्टिव है, Read => पढ़ें, Readable =>
, difference update, discard, intersection, intersection update, is disjoint, is subset, is superset, symmetric difference, symmetric difference update, union, close, detach, file number, flush, is interactive, read, readable, read line, read lines, seek, seekable, tell, truncate, writable, write, write lines, and, as, assert, break, class, continue, define, delete, else if, else, except, False, finally, for, from, global, if, import, in, is, lambda, None, non-local, not, or, pass, raise exception, return, True, try, while, with, yield, Arithmetic Error, Assertion Error, Attribute Error, Exception, End Of File Error, Floating Point Error, Generator Exit, Import Error, Indentation Error, Index Error, Key Error, Keyboard Interrupt, Lookup Error, Memory Error, Name Error, Not Implemented Error, OS Error, Overflow Error, Reference Error, Runtime Error, Stop Iteration, Syntax Error, Tab Error, System Error, System Exit, Type Error, Unbound Local Error, Unicode Error, Unicode Encode Error, Unicode Decode Error, Unicode Translate Error, Value Error, Zero Division Error.

From Keys => कुंजिकाओं से, Get => प्राप्त करें, Items => आइटम्स, Keys => कुंजी, Pop Item => आइटम हटाएं, Set Default => डिफ़ॉल्ट सेट करें, Update => अपडेट करें, Values => मान, Add => जोड़ें, Difference => अंतर, Difference Update => अंतर अपडेट करें, Discard => त्याग दें, Intersection => आंशिक समानता, Intersection Update => आंशिक समानता अपडेट करें, Is Disjoint => असंगत है, Is Subset => उपसमुह है, Is Superset => सुपरसेट है, Symmetric Difference => समष्टिय अंतर, Symmetric Difference Update => समष्टिय अंतर अपडेट करें, Union => संयुक्त, Close => बंद करें, Detach => अलग करें, File Number => फ़ाइल नंबर, Flush => फ्लश करें, Is Interactive => सक्रिय है, Read => पढ़ें, Readable => पढ़ने योग्य, Read Line => लाइन पढ़ें, Read Lines => लाइनों को पढ़ें, Seek => खोजें, Seekable => खोज योग्य, Tell => बताएं, Truncate => कटौती करें, Writable => लिखने योग्य, Write => लिखें, Write Lines => ला
.

अंतर अद्यतन करें, त्याग करें, अंतर्गत, अंतर्गत अद्यतन करें, अलग है, उपसमुच्च है, सुपरसेट है, समानता अंतर, समानता अंतर अद्यतन करें, संयुक्ति,
, seekable, tell, truncate, writable, write, write lines.

बंद करें, अलग करें, फाइल संख्या, धुएँ, इंटरैक्टिव है, पढ़ें, पठनीय, पंक्ति पढ़ें, पंक्तियाँ पढ़ें, ढूँढें, ढूँढने योग्य, बताएं, कटौती, लिखने योग्य, लिखें, पंक्तियाँ लिखें।
, class, continue, define, delete, else if, else, except, False, finally, for, from, global, if, import, in, is, lambda, None, non-local, not, or, pass, raise exception, return, True, try, while, with, yield, Arithmetic Error, Assertion Error, Attribute Error, Exception, End Of File Error, Floating Point Error, Generator Exit, Import Error, Indentation Error, Index Error, Key Error, Keyboard Interrupt, Lookup Error, Memory Error, Name Error, Not Implemented Error, OS Error, Overflow Error, Reference Error, Runtime Error, Stop Iteration, Syntax Error, Tab Error, System Error, System Exit, Type Error, Unbound Local Error, Unicode Error, Unicode Encode Error, Unicode Decode Error, Unicode Translate Error, Value Error, Zero Division Error

seekable => खोजने योग्य
tell => बताना
truncate => कटना
writable => लिखने योग्य
write => लिखना
write lines => लाइनों को लिखना
and => और
as => जैसा
assert => दावा
break => तोड़ना
class => वर्ग
continue => जारी रखें
define => परिभाषित
delete => हटाना
else if => अन्यथा अगर
else => अन्यथा
except => छोड़कर
False => झूठ
finally => अंत में
for => के लिए
from => से
global => वैश्वीक
if => अगर
import => आयात
in => में
is => है
lambda => लाम्बडा
None => कोई नहीं
non-local => गैर-स्थानीय
not => नहीं
or => या
pass => पास
raise exception => घटना उत्पन्न करें
return => लौटना
True => सही
try => कोशिश
while => जबकि
with => के साथ
yield => उत्पाद
Arithmetic Error => गणित त्रुटि
Assertion Error => दावा त्रुटि
Attribute Error => विशेषता त्रुटि
Exception => अपवाद
End Of File Error => फ़ाइल अंत त्रुटि
Floating Point Error => फ्लोटिंग पॉइंट त्रुटि
Generator Exit => जनरेटर निकास
Import Error => आयात त्रुटि
Indentation Error => इंडेंटेशन त्रुटि
Index Error => सूचकांक त्रुटि
Key Error => कुंज
, from, global, if, import, in, is, lambda, None, non-local, not, or, pass, raise exception, return, True, try, while, with, yield

वर्ग, जारी रखें, परिभाषित करें, हटाएँ, अन्यथा अगर, अन्यथा, छोड़कर, झूठा, अंत में, के लिए, से, वैश्वीक, अगर, आयात, में, है, लाम्ब्डा, कुछ नहीं, ग्लोबल, नहीं, या, पास, घटना निर्वहन, लौटें, सच, कोशिश करें, जबकि, के साथ, सौभाग्य, गणना त्रुटि, अनुमान त्रुटि, गुणवत्ता त्रुटि, अवघड़, अंत फ़ाइल त्रुटि, दशमलव अंक त्रुटि, उत्पादक निकास, आयात त्रुटि, इंडेंटेशन त्रुटि, अनुक्रम त्रुटि, कुंजी त्रुटि, कुंजीबोर्ड निरस्त, खोज त्रुटि, मेमोरी त्रुटि, नाम त्रुटि, अनुबंधित लोकल त्रुटि, अनुपलब्धता त्रुटि, ओएस त्रुटि, अतिरिक्त त्रुटि, संदर्भ त्रुटि, रनटाइम त्रुटि, आइटरेशन रोकें, व्याकरण त्रुटि, टैब त्रुटि, सिस्टम त्रुटि, सिस्टम निकास, प्र
, or, pass, raise exception, return, True, try, while, with, yield, Arithmetic Error, Assertion Error, Attribute Error, Exception, End Of File Error, Floating Point Error, Generator Exit, Import Error, Indentation Error, Index Error, Key Error, Keyboard Interrupt, Lookup Error, Memory Error, Name Error, Not Implemented Error, OS Error, Overflow Error, Reference Error, Runtime Error, Stop Iteration, Syntax Error, Tab Error, System Error, System Exit, Type Error, Unbound Local Error, Unicode Error, Unicode Encode Error, Unicode Decode Error, Unicode Translate Error, Value Error, Zero Division Error

से, वैश्विक, अगर, आयात, में, है, लाम्ब्डा, कुछ नहीं, ग्राहक-स्थानीय नहीं, नहीं, या, पास, घटना विफल करना, लौटें, सच, कोशिश, जबतक, के साथ, उत्पाद, गणना त्रुटि, गुणवत्ता त्रुटि, असत्यापन त्रुटि, अपवाद, फ़ाइल के अंत त्रुटि, दशमलव बिंदु त्रुटि, उत्पादक निकास, आयात त्रुटि, इंडेंटेशन त्रुटि, सूची त्रुटि, कुंजी त्रुटि, कीबोर्ड निरस्त, खोज त्रुटि, मेमोरी त्रुटि, नाम त्रुटि, नहीं लागू किया गया त्रुटि, ओएस त्रुटि, अधिलेख त्रुटि, संदर्भ त्रुटि, रनटाइम त्रुटि, रुकना अवरोध, व्याख्या त्रुटि, टैब त्रुटि, सिस्टम त्रुटि, सिस्टम निकास, प्रकार त्रुटि, असंगत स्थानीय त्रुटि, यू
, Assertion Error, Attribute Error, Exception, End Of File Error, Floating Point Error, Generator Exit, Import Error, Indentation Error, Index Error, Key Error, Keyboard Interrupt, Lookup Error, Memory Error, Name Error, Not Implemented Error, OS Error, Overflow Error, Reference Error, Runtime Error, Stop Iteration, Syntax Error, Tab Error, System Error, System Exit, Type Error, Unbound Local Error, Unicode Error, Unicode Encode Error, Unicode Decode Error, Unicode Translate Error, Value Error, Zero Division Error

या, पास, घटना विफल करें, वापसी, सच, कोशिश करें, जबतक, के साथ, उपहार, गणितीय त्रुटि, असर्थ त्रुटि, विशेषता त्रुटि, अपवित्र, फ़ाइल अंत त्रुटि, दशमलव अंक त्रुटि, जनरेटर निकास, आयात त्रुटि, इंडेंटेशन त्रुटि, सूचकांक त्रुटि, कुंजी त्रुटि, कुंजीबोर्ड निरस्त, खोज त्रुटि, मेमोरी त्रुटि, नाम त्रुटि, लागू नहीं किया गया त्रुटि, OS त्रुटि, अधिलेखन त्रुटि, संदर्भ त्रुटि, रनटाइम त्रुटि, आइटरेशन रोकें, वाक्यविन्यास त्रुटि, टैब त्रुटि, सिस्टम त्रुटि, सिस्टम निकास, प्रकार त्रुटि, असंबद्ध स्थानीय त्रुटि, यूनिकोड त्रुटि, यूनिकोड एन्कोड त्रुटि, यूनिकोड डेकोड त्रुटि, यूनिकोड अन
, Keyboard Interrupt, Lookup Error, Memory Error, Name Error, Not Implemented Error, OS Error, Overflow Error, Reference Error, Runtime Error, Stop Iteration, Syntax Error, Tab Error, System Error, System Exit, Type Error, Unbound Local Error, Unicode Error, Unicode Encode Error, Unicode Decode Error, Unicode Translate Error, Value Error, Zero Division Error

दावा त्रुटि, विशेषता त्रुटि, अपवाद, फ़ाइल के अंत त्रुटि, फ्लोटिंग पॉइंट त्रुटि, जनरेटर निकास, आयात त्रुटि, इंडेंटेशन त्रुटि, सूचकांक त्रुटि, कुंजी त्रुटि, कीबोर्ड का उल्लंघन, खोज त्रुटि, मेमोरी त्रुटि, नाम त्रुटि, लागू नहीं किया गया त्रुटि, ओएस त्रुटि, अधिलेखन त्रुटि, संदर्भ त्रुटि, रनटाइम त्रुटि, आगामी आईटरेशन रोकें, वाक्यविन्यास त्रुटि, टैब त्रुटि, सिस्टम त्रुटि, सिस्टम निकास, प्रकार त्रुटि, असंगत स्थानीय त्रुटि, यूनिकोड त्रुटि, यूनिकोड एनकोड त्रुटि, यूनिकोड डिकोड त्रुटि, यूनिकोड अनुवाद त्रुटि, मान त्रुटि, शून्य विभाजन त्रुटि।
, Syntax Error, Tab Error, System Error, System Exit, Type Error, Unbound Local Error, Unicode Error, Unicode Encode Error, Unicode Decode Error, Unicode Translate Error, Value Error, Zero Division Error

कीबोर्ड इंटररप्ट: कीबोर्ड विराम, लुकअप त्रुटि: लुकअप त्रुटि, मेमोरी त्रुटि: मेमोरी त्रुटि, नाम त्रुटि: नाम त्रुटि, नहीं लागू किया गया त्रुटि: नहीं लागू किया गया त्रुटि, OS त्रुटि: OS त्रुटि, अधिलेखन त्रुटि: अधिलेखन त्रुटि, संदर्भ त्रुटि: संदर्भ त्रुटि, रनटाईम त्रुटि: रनटाईम त्रुटि, रूपांतरण रोकें: रूपांतरण रोकें, वाक्यरचना त्रुटि: वाक्यरचना त्रुटि, टैब त्रुटि: टैब त्रुटि, सिस्टम त्रुटि: सिस्टम त्रुटि, सिस्टम निकास: सिस्टम निकास, प्रकार त्रुटि: प्रकार त्रुटि, असंरक्षित स्थानीय त्रुटि: असंरक्षित स्थानीय त्रुटि, यूनिकोड त्रुटि: यूनिकोड त्रुटि, यूनिकोड एन्कोड त्रुटि: यूनिकोड एन्कोड त्रुटि, यूनिकोड डि
, Value Error, Zero Division Error

सिन्टैक्स त्रुटि, टैब त्रुटि, सिस्टम त्रुटि, सिस्टम निकास, प्रकार त्रुटि, असंबद्ध स्थानीय त्रुटि, यूनिकोड त्रुटि, यूनिकोड एन्कोड त्रुटि, यूनिकोड डीकोड त्रुटि, यूनिकोड अनुवाद त्रुटि, मूल्य त्रुटि, शून्य विभाजन त्रुटि।


मान त्रुटि, शून्य विभाजन त्रुटि
