απόλυτη τιμή
όλα
οποιαδήποτε
ascii
δυαδικό
μπουλέαν
πίνακας byte
bytes
κλήσιμο
χαρακτήρας
class method => μέθοδος κλάσης
compile => κατακερματίστε
complex => σύνθετο
delete attribute => διαγράψτε το χαρακτηριστικό
dictionary => λεξικό
directory => κατάλογος
divide modulus => διαιρέστε το μόδουλο
enumerate => αρίθμηση
evaluate => αξιολόγηση
execute => εκτέλεση
filter => φίλτρο
floating point => πλευρικής τιμής
format => μορφοποίηση
frozen set => παγωμένο σύνολο
get attribute => πάρε χαρακτηριστικό
globals => καθολικά
has attribute => έχει χαρακτηριστικό
hash => κατακερματισμός
help => βοήθεια
hexadecimal => εξαδική
identity => ταυτότητα
input => είσοδος
integer => ακέραιος
is instance => είναι στιγμιότυπο
is subclass => είναι υποκλάση
iterator => επαναληπτής
length => μήκος
list => λίστα
locals => τοπικοί
map => χάρτης
maximum => μέγιστο
memory view => προβολή μνήμης
minimum => ελάχιστο
next => επόμενο
object => αντικείμενο
octal => οκταδικό
open => ανοιξε
ordinal => διάταξης
power => δύναμη
print => τύπωσε
property => ιδιότητα
range => εύρος
represent => αναπαράσταση
reversed => ανεστραμμένο
round => στρογγυλοποίηση
set => σύνολο
set attribute => ορισμός ιδιότητας
slice => κομμάτι
sorted => ταξινομημένο
static method => στατική μέθοδος
string => συμβολοσειρά
summation => άθροιση
superset => υπερσύνολο
tuple => συμβολοσειρά διαστάσεων
type => τύπος
variables => μεταβλητές
zip => συμπίεση
capitalize => κεφαλαία
case fold => συμπίεση πεζών
center => κεντράρισμα
count => μετρήσεις
encode => κωδικοποίηση
ends with => τελειώνει με
expand tabs => επεκτείνετε τα tabs
find => βρείτε
format map => χάρτης μορφοποίησης
index => δείκτης
is alphanumeric => είναι αλφαριθμητικό
is alphabetic => είναι αλφαβητικό
is ascii => είναι ascii
είναι δεκαδικό
είναι ψηφίο
είναι αναγνωριστικό
είναι μικρό
είναι αριθμητικό
είναι εκτυπώσιμο
είναι κενό
είναι τίτλος
είναι κεφαλαία
συνδέσου
left justify => αριστερή ισορροπία
lower => μείωση
left strip => αριστερή στήλη
make translation => δημιουργία μετάφρασης
partition => διαίρεση
replace => αντικατάσταση
reverse find => αντίστροφη εύρεση
reverse index => αντίστροφος δείκτης
right justify => δεξιά ισορροπία
right partition => δεξιά διαίρεση
right split => διαίρεση δεξιά
right strip => απομάκρυνση δεξιά
split => διαίρεση
split lines => διαίρεση γραμμών
starts with => ξεκινά με
strip => απομάκρυνση
swap case => αντιστροφή κεφαλαίων
title => τίτλος
translate => μεταφράστε
uppercase => κεφαλαία
zero fill => μηδενισμός
append => προσάρτηση
clear => καθαρισμός
copy => αντιγραφή
extend => επέκταση
insert => εισαγωγή
pop => αναστολή
remove => αφαίρεση
reverse => αναστροφή
sort => ταξινόμηση
από
αποκτήστε
στοιχεία
κλειδιά
ανακτήστε το στοιχείο
ορίστε το προεπιλεγμένο
ενημέρωση
τιμές
προσθήκη
διαφορά
διαφορά ενημέρωσης
απορρίπτω
τομή
ενημέρωση τομής
είναι ασύνδετο
είναι υπομονάδα
είναι υπερμονάδα
ισοσκελής διαφορά
ενημέρωση ισοσκελούς διαφοράς
ένωση
close => κλείσιμο
detach => αποσυνδέση
file number => αριθμός αρχείου
flush => ξεπλήρωση
is interactive => είναι διαδραστικό
read => ανάγνωση
readable => αναγνώσιμο
read line => ανάγνωση γραμμής
read lines => ανάγνωση γραμμών
seek => αναζήτηση
seekable => αναζητήσιμο
tell => πείτε
truncate => στραγγίζω
writable => εγγράψιμο
write => γράψτε
write lines => γράψτε γραμμές
and => και
as => ως
assert => πιστεύω
break => παρακαλώ
class => κλάση
continue => συνέχισε
define => ορίστε
delete => διαγράψτε
else if => αλλιώς αν
else => αλλιώς
except => εκτός
false => ψευδές
finally => τέλος
for => για
από
καθολικό
αν
εισαγωγή
μέσα
είναι
λάμδα
κανένα
μη-τοπικό
μη
or => ή
pass => παρέλαβε
raise exception => αναγκάστε εξαίρεση
return => επιστροφή
true => αληθής
try => προσπαθήστε
while => ενώ
with => με
yield => δώσε
arithmetic error => αριθμητικό λάθος
assertion error => λάθος απόλυσης
attribute error => λάθος χαρακτηριστικού
exception => εξαίρεση
end of file error => λάθος τέλους αρχείου
floating point error => λάθος πλειάδας πόντων
generator exit => έξοδος γεννήτριας
import error => λάθος εισαγωγής
indentation error => λάθος εσοχής
index error => λάθος ευρετηρίου
key error => λάθος κλειδιού
διακοπή πληκτρολογίου
σφάλμα αναζήτησης
σφάλμα μνήμης
σφάλμα ονόματος
σφάλμα μη υλοποιημένο
σφάλμα λειτουργικού συστήματος
υπερχείλιση σφάλματος
σφάλμα αναφοράς
σφάλμα εκτέλεσης
σταμάτημα επανάληψης
συντακτικό λάθος
λάθος καρτέλας
σφάλμα συστήματος
έξοδος συστήματος
λάθος τύπου
λάθος μη συνδεδεμένου τοπικού
λάθος unicode
λάθος κωδικοποίησης unicode
λάθος αποκωδικοποίησης unicode
λάθος μετάφρασης unicode
value error => λάθος τιμής
zero division error => λάθος μηδενικού διαίρεσης
