absolute value => নিরপেক্ষ মান
all => সব
any => যেকোন
ascii => এসকিউআই
binary => দ্বিতীয়
boolean => বুলিয়ান
byte array => বাইট অ্যারে
bytes => বাইট
callable => কলেবল
character => অক্ষর
class method => ক্লাস পদ্ধতি
compile => কম্পাইল
complex => কম্প্লেক্স
delete attribute => বৈশিষ্ট্য মুছুন
dictionary => অভিধান
directory => ডিরেক্টরি
divide modulus => ভাগ মডুলাস
enumerate => তালিকাভুক্ত করা
evaluate => মূল্যায়ন করা
execute => সম্পাদন করা
filter => ফিল্টার
floating point => ফ্লোটিং পয়েন্ট
format => ফর্ম্যাট
frozen set => ফ্রোজেন সেট
get attribute => এট্রিবিউট পাওয়া
globals => গ্লোবাল
has attribute => হ্যাস এট্রিবিউট
hash => হ্যাশ
help => সহায়তা
hexadecimal => হেক্সাডেসিম্যাল
identity => পরিচয়
input => ইনপুট
integer => পূর্ণসংখ্যা
is instance => এর অবজেক্ট
is subclass => এর উপজাতি
iterator => অ্যাকসেসর
length => দৈর্ঘ্য
list => তালিকা
locals => স্থানীয়
map => ম্যাপ
maximum => সর্বোচ্চ
memory view => স্মৃতি_দৃশ্য
minimum => সর্বনিম্ন
next => পরবর্তী
object => বস্তু
octal => আটকেল
open => খোলা
ordinal => অনুক্রমিক
power => শক্তি
print => প্রিন্ট
property => গুণ
range => পরিসীমা
represent => প্রতিনিধিত্ব করা
reversed => উল্টানো
round => গোণাঙ্কিত
set => সেট
set attribute => গুণ স্থাপন করা
slice => কাটা
sorted => ক্রমবদ্ধ
static method => স্থির পদ্ধতি
string => স্ট্রিং
summation => যোগফল
superset => সুপারসেট
tuple => টুপল
type => টাইপ
variables => ভেরিয়েবল
zip => জিপ
capitalize => ক্যাপিটালাইজ
case fold => কেস ফোল্ড
center => সেন্টার
count => গণনা
encode => এনকোড
ends with => শেষ হয়
expand tabs => ট্যাব সম্প্রসারণ
find => খুঁজুন
format map => ফর্ম্যাট ম্যাপ
index => সূচক
is alphanumeric => অক্ষর-সংখ্যার হয়
is alphabetic => অক্ষরাদির হয়
is ascii => এএসসিআই হয়
is decimal => ডেসিমেল হয়
is digit => সংখ্যা হয়
is identifier => আইডেনটিফায়ার হয়
is lower => কম হয়
is numeric => সংখ্যায়িত হয়
is printable => প্রিন্ট করা যাবে
is space => স্পেস হয়
is title => শিরোনাম হয়
is uppercase => উপরের হয়
যোগ করুন.
left justify => বামে স্থির করুন
lower => কম
left strip => বাম স্ট্রিপ
make translation => অনুবাদ করুন
partition => ভাগ করুন
replace => প্রতিস্থাপন করুন
reverse find => উল্টো খুঁজুন
reverse index => উল্টো সূচক
right justify => ডানে স্থির করুন
right partition => ডান ভাগ করুন
right split => ডান বিভাজন
right strip => ডান স্ট্রিপ
split => বিভাজন
split lines => লাইন বিভাজন
starts with => শুরুর সাথে
strip => স্ট্রিপ
swap case => কেস স্বাদেশ
title => শিরোনাম
translate => অনুবাদ
uppercase => বড় হাতের অক্ষর
zero fill => শূন্য ফিল
append => যোগ করা
clear => সাফ করা
copy => অনুলিপি
extend => বহাল করা
insert => প্রবেশ করা
pop => আউট করা
remove => অপসারণ করা
reverse => উল্টান
sort => সাজান
from keys => কীওয়ার্ড থেকে,
get => পাওয়া,
items => আইটেমস,
keys => কীওয়ার্ড,
pop item => আইটেম পপ,
set default => ডিফল্ট সেট করুন,
update => আপডেট,
values => মান,
add => যোগ করুন,
পার্থক্য.
difference update => পার্থক্য আপডেট
discard => বাতিল
intersection => অন্তর
intersection update => অন্তর আপডেট
is disjoint => পৃথক
is subset => উপসেট
is superset => সুপারসেট
symmetric difference => সমতলীয় পার্থক্য
symmetric difference update => সমতলীয় পার্থক্য আপডেট
union => যুক্তি
close => বন্ধ করুন
detach => অপসারণ করুন
file number => ফাইল নম্বর
flush => ফ্লাশ করুন
is interactive => আন্তরিক কি
read => পড়ুন
readable => পঠনযোগ্য
read line => লাইন পড়ুন
read lines => লাইন গুলি পড়ুন
seek => অনুসন্ধান করুন
seekable => खोजनीय
tell => बताना
truncate => कम करना
writable => लिखने योग्य
write => लिखें
write lines => लाइनों को लिखें
and => और
as => के रूप में
assert => दावा करना
break => तोड़ना
class => ক্লাস
continue => চালিয়ে যান
define => নির্ধারণ
delete => মুছে ফেলুন
else if => অন্যথায় যদি
else => অন্যথায়
except => বিশেষ করে
false => মিথ্যা
finally => শেষ করে
for => জন্য
from => হইতে
global => গ্লোবাল
if => যদি
import => আমদানি
in => মধ্যে
is => হইবে
lambda => ল্যাম্বডা
none => কিছুই না
non-local => অ-স্থানীয়
not => না
or => অথবা
pass => পাস
raise exception => বিরুদ্ধে অপব্যাপ্তি উঠাও
return => ফিরে আসুন
true => সত্য
try => চেষ্টা করুন
while => যখন
with => সঙ্গে
yield => প্রদান
arithmetic error => গণিত ত্রুটি
assertion error => নিশ্চিতকরণ ত্রুটি
attribute error => বৈশিষ্ট্য ত্রুটি
exception => বিপত্তি
end of file error => ফাইলের শেষ ত্রুটি
floating point error => ফ্লোটিং পয়েন্ট ত্রুটি
generator exit => জেনারেটর বাহির
import error => আমদানি ত্রুটি
indentation error => আওতাভুক্তি ত্রুটি
index error => সূচী ত্রুটি
key error => কী ত্রুটি
keyboard interrupt => কীবোর্ড বিরতি
lookup error => লুকআপ ত্রুটি
memory error => মেমরি ত্রুটি
name error => নাম ত্রুটি
not implemented error => অসমর্থিত ত্রুটি
os error => অপারেটিং সিস্টেম ত্রুটি
overflow error => অতিরিক্ত ত্রুটি
reference error => রেফারেন্স ত্রুটি
runtime error => রানটাইম ত্রুটি
stop iteration => আইটারেশন বন্ধ করুন
syntax error => বাক্যগঠন ত্রুটি
tab error => ট্যাব ত্রুটি
system error => সিস্টেম ত্রুটি
system exit => সিস্টেম বাহির
type error => টাইপ ত্রুটি
unbound local error => অবর্ণিত স্থানীয় ত্রুটি
unicode error => ইউনিকোড ত্রুটি
unicode encode error => ইউনিকোড এনকোড ত্রুটি
unicode decode error => ইউনিকোড ডিকোড ত্রুটি
unicode translate error => ইউনিকোড অনুবাদ ত্রুটি
value error => মান ত্রুটি
zero division error => শূন্য ভাগ ত্রুটি
