absolute value : িশ্ত মান (onishchiti man)
all : সব (sab)
any : কোন (kon)
ascii : েি (aseaisi)
binary : দু(dui-yangshtho)
boolean : লোজিকাল (logical)
byte array : eno র (unoreno adhar)
bytes : ে (unore)
callable : Lা(bhramhalu)
character : (jara)
class method : শ্রেনী মে(shreni mehtu)
compile : সতি করা (sangati karacha)
complex : পরবক (porbhabaak)
delete attribute : ি য়ান 沙ম (etidr odhikar upasham)
dictionary : োা সুক্ত জাম (alochona sangyukta ontjam)
directory : ল্র (foldaara)
divide modulus : বির্তন য়ান শম (birtanna odhikar upasham)
enumerate : ুন করা (anushthhaan koracha)
evaluate : ুত করা (anuddhaagata karacha)
execute : সতি করা (sangati karacha)
filter : ল্র (philtāra)
floating point : তো পয়ান্(bhōtēā pyānḍa)
format : মে(formeta)
frozen set : জমি সে(jamī sēṭa)
get attribute : риবুন (ātribuṭi khon)
globals : গ্লোবাল (glōbāla)
has attribute : যাযা (ēchō ôchō achhe)
hash : হ্যাশ (hyāsh)
help : সা (sūchnā)
hexadecimal : ক사দম সযা (ghēksadam sankhya)
identity : akti (pronounced as "ash-ak-tee")
input : পুट (pronounced as "in-poot")
integer : integer
is instance : instance
is subclass : subclass
iterator : iterator
length : লম্বা (pronounced as "lom-baa")
list : তালিকা (pronounced as "taalikaa")
locals : স্নী (pronounced as "shtaanii")
map : map
maximum : সর্বোchsheapest (Shromochochhosh)
memory view : মেমোরি (Memori Bhuvan)
minimum : নিম্নো(Nimontho)
next : পরবে (Porbe)
object : bjekt (Obbjective)
octal : ল (Ashonal)
open : লা (Kholah)
ordinal : স (Suchak)
power : শক্তি (Shakti)
print : পা (Chapa)
property : সিন্যাस (Shobhinyaas)
range : পরীক্ (Porieksha)
represent : প্রতিনিদেশ (Pratinidhi)
reversed : ggi (Aggi)
round : সো (Sonchha)
set : সমুহাय (Samuhay)
set attribute : সমুহায় বস্ত (Samuhay Osshovabasta)
slice : া (Chhada)
sorted : সজ্जিত (Sajjit)
static method : স্পদ্ি (Sthiik Paddhati)
string : স্রি(shtring)
summation : সমাতনা (samadhaatonaa)
superset : সুপা্ (supathaandhure)
tuple : বল (tabla)
type : (doron)
variables : গের (vengeler)
zip : জিপ (zip)
capitalize : কাপিলা (kaapitaalaj)
case fold : কেস ল্(kes foald)
center : সেン্র (santra)
count : গ(gongo)
encode : কো(kōṛi
ends with : সমাপ্তি সহ (samāpti sah)
expand tabs : বিল ুত করা (tēbila anushthiti kôra)
find : জা (khōjā)
format map : ্মাPG (arthēt māpa)
index : ্ক্স (aindēks)
is alphanumeric : ্র া ানের র  র (ol-phābe r abar ômane r ôvitôr ekatī ôvitôr)
is alphabetic : ্র া ানের র  র (ol-phābe r abar ômane r ôvitôr ekatī ôvitôr)
is ascii : র (asūcī ōbhishār ōvitôr)
is decimal : স্রান্ত  (Sankraantan Tonk)
is digit : মাত্র (Ansure Maatrapha)
is identifier : া যোগ (Aina O Abyiog)
is lower : ্ (Choit O Akshor)
is numeric : সযাত  (Sankhyata Tonk)
is printable : প্রের  (Prer Tonk)
is space : স্পেস  (Space Tonk)
is title : র  (Utsor Tonk)
is uppercase : ে ্ (Adree Akshor)
join : জোন (Jodon)
left justify : বা  রত (Ba khoni ferota)
lower : নী (Niche)
left strip : বা  রের র (Ba khoni apurer upor)
make translation : ুবাদ করা (Anubad korar)
partition : গ (Vaga)
replace : স্তি পরিবর্তন (Sthiti paribartan)
reverse find : ে  Jailed (Aboli kho jailed)
reverse index : ে ্দেкс (Aboli indeks)
right justify : রত (Dha khoni ferota)
right partition : গ (Dha vaga)
right split : ুসার বি্ত করা (Anusaar bibhakt kora)
right strip : ুসার লে लি করা (Anusaar chhelle khaali kora)
split : বি্ত করা (Bibhakt kora)
split lines : পাতা বি্ত করা (Pataa bibhakt kora)
starts with : শুরু করে ার েক েক েক েক েক েক েক েক েক েক েক েক েক েক েক েক েক েক েক েক েক েক েক েক েক েক েক েক েক েক েক েক েক েক েক েক েক েক েক েক েক েক েক েক েক েক েক েক েক েক েক েক েক েক েক েক েক েক েক েক েক েক েক েক েক েক েক েক েক েক েক েক েক েক েক েক েক েক েক েক েক েক েক েক েক েক েক েক েক েক েক েক েক েক েক েক েক েক েক েক েক েক েক েক েক েক েক েক েক েক েক েক েক েক েক েক েক েক েক েক েক েক েক েক েক েক েক েক েক েক েক েক েক েক েক েক েক েক েক েক েক েক েক েক েক েক
strip : -
swap case : -
title : -
translate : -
uppercase : -
zero fill : সা প(shushona poronno)
append : যোগোে (oyogeadore)
clear : ি(chhariang)
copy : কপি (kobi)
extend : ো সি (aroh khasi)
insert : দান (amdan)
pop : (oti)
remove : সার(uposoron)
reverse : িহাস (aitihas)
sort : (bhasha)
from keys : স্কে Jeux (Ske Jules)
get : পা়া (Paoa)
items : েমস (Aitamas)
keys : (Khuuti)
pop item : েকবার েম (Onekbar Aitam)
set default : দფROR েম (Dfor Ror Aitam)
update : েম (Apdate Aitam)
values : মানস (Monash)
add : ো েম (Arro Aitam)
difference : েম (Fail Aitam)
difference update : ্তর dulete (Ontar Apdulen)
discard : বাকি াম (Baki Thaem)
intersection : সোগ (Sangyog)
intersection update : সোগ দুলে (Sangyog Apdulen)
is disjoint : রি (Aporichashtha)
is subset : ্তর গ (Ontar Bhag)
is superset : ্তর সহ (Ontar Upasah)
symmetric difference : সমবায় delta (Samabay Delta)
symmetric difference update : সমবায় ল್ দুলে (Samabay Deltathe Apdulen)
union : ্য সোগ (Ekta Sangyog)
close : বাল (Bangla)
detach : ্তর্ক (Antarbhuk)
file number : স্যা (Phail Shankha)
flush : পরিদ় (Porishodeshdo)
is interactive : ক ার   (Tak Amar Oste Asthe)
read : পা (Poda)
readable : পাযাযাকলে  ার   (Porao Yachai Yachai Thakle Amar Oste Asthe)
read line : লা পা (Ek Laine Poda)
read lines : লাগুলো পা (Laingulo Poda)
seek : জা (Khoja)
seekable : সীকবাল (shikbal)
tell : তয (tathya)
truncate : ুত (anuvet)
writable : লিী (lihanii)
write : লি(liha)
write lines : লিনো (lihano)
and : (ebang)
as : যে(jibhai)
assert : স্প্(shapoorna)
break : বি(bibhash)
class : ক্লাস (kloṣ)
continue : ের প (āgēr paṭh)
define : সমিত করা (samaṃohita kara)
delete : মু রTeX (muccē ferō tex)
else if : ি সিদ্(āti śiddha iu)
else : ্য (any)
except : ার (āvāra ei)
False : লো (bhalō)
finally : শেস্ (śēṣa ubastā)
for : (o)
from : াবশি (Onaabashi)
global : সকলো প্রতি (Sokoloprotiushthi)
if : যদি (Yodi)
import : দান (Amodon)
in : নে (Ekhane)
is : হল (Hal)
lambda : লাмбদা нкció (Lambda phunkcija)
None : না(Nai)
non-local : ্ত্রী স (Ostree Suuchak)
not : না (Na)
or : র (āra)
pass : পাস (pās)
raise exception : ার্তি াত (abārtī utshāgatha)
return : প্রত্যাशিত (pratyāshit)
True : সত্ (satya)
try : (cēṣṭā)
while : (ekhono)
with : সত (saṃgata)
yield : ্(ōild)
Arithmetic Error : ika (aṇśika thā'i)
Assertion Error : ার্তি যোগ (abārtī abhiyog)
Attribute Error : ika বাস (aṅśika avibās)
Exception : ার্তি াত (abārtī utshāgatha)
End Of File Error : স্রম(phā'il saramaṇa thā'i)
Floating Point Error : লোপ(flōtitipaṭha thā'i)
Generator Exit : জেনারে ্সি(jēnārētora ekxit)
Import Error : দান যোগ (amadāna ābhinyog)
Indentation Error : ika বাস (aṅśika avibās)
Index Error : ika ন্ন (aṅśika avinna)
Key Error : িশ্বাস ত্রু ROR (Ovisotto Shombhuvesh Trito Ror)
Keyboard Interrupt : রika ত্রু ROR (Adhikarika Shombhuvesh Trito Ror)
Lookup Error : গে নো মা(Bhenge Uthano Mash)
Memory Error : পরিসমাপতি ROR (File Parisammapti Error)
Name Error : লোপয়াROR (Floating Point Payaanchh Error)
Not Implemented Error : জেনারে ্সি(Jenarator Excita)
OS Error : দানী াম ROR (Amadani Asam Error)
Overflow Error : সা রু ROR (Suchnana Thruti Error)
Reference Error : ROR (Ansu Error)
Runtime Error : ROR (Khondo Dibe Error)
Stop Iteration : কিবোর্্রত (Kiborird Intaarbuut)
Syntax Error : লুক র (Lukuup Erro)
Tab Error : মেমোরি র (Memori Eror)
System Error : নাম র (Nam Erro)
System Exit : না সম্পাদিত র (No Sampaadito Eror)
Type Error : ера র (Opearating System Eror)
Unbound Local Error : ার (Phulaai Eror)
Unicode Error : র (Asho Eror)
Unicode Encode Error : রানтайম র (RaanTime Eror)
Unicode Decode Error : যোগ (Aachha Abhijog)
Unicode Translate Error : সমগ (Samanglog)
Value Error : তাবার র (Taba-r err-ra)
Zero Division Error : প্রতিন র (Pratishthhan-er err-ra)
