absolute value : مراسیم وه‌لان (mara-sim-welan)
all : ھەموو (hemû)
any : کەسدی (kêsadî)
ascii : ئاسی سیمبول (âsî cîmbûl)
binary : دووجی سیمبول (dowujê cîmbûl)
boolean : بولیان (boliyan)
byte array : گروه بيت (giruha bite)
bytes : بيت (bite)
callable : پویزی (pêwazî)
character : خا ئەزموو (xâce azmoô)
class method : کەوتی کلاس (reza-koti kelas)
compile : ترجمه‌ونووس (tarjamah-w-nivos)
complex : پەقeta (peqeta)
delete attribute : ئاتری بەرگری بەمان (aatari bargiri bemaan)
dictionary : فرهنگ ووچ (ferhang-e woch)
directory : ديال Bah (deyalk bah)
divide modulus : یل و بعداول (vial ve baad awal)
enumerate : لیست کردن (list kardan)
evaluate : اوزonte (ozonte)
execute : انجام بگذار (enjaam begozar)
filter : فیلتر (filtr)
floating point : پوانت هوايی (pavant hoveyî)
format : فرمت (format)
frozen set : گروه مقعد ست (giruah maqased set)
get attribute : ئوه‌سازی بخش (jêohe sazi bakhsh)
globals : گロبال‌ها (globalehâ)
has attribute : ئوه‌سازی بخش کرد (jêohe sazi bakhsh kard)
hash : هش (hash)
help : خوragen (kholaren)
hexadecimal : شش دیسima (shesh dyesima)
identity : فرمان (farmān)
input : وارد (wārd)
integer : عددی (adadi)
is instance : هەباردەوەی (həlbžardawē)
is subclass : زرتی کلاسیک (zōrtī kelāsik)
iterator : گەان (gerān)
length : پایandis - (pāyandīs)
list : لیست (list)
locals : مقامی (makāmi)
map : نقشه‌ (naqše)
maximum : مەксиموم (Maksimum)
memory view : یده‌وان مەموری (Vidayan Memuri)
minimum : مینیموم (Minimu)
next : پشتیبان (Pashtiban)
object : وسیله‌ی چالاک (Vaseela-e Chalak)
octal : 八进制 (Haft Jariyahi)
open : باز (Baz)
ordinal : ترتیبی (Tartibi)
power : قوت (Qat)
print : چاپ‌خوانی (Chap-Khahani)
property : پارگی (pârgî)
range : دوات‌ر (dowāt-e rezh)
represent : نمایش (namâysh)
reversed : تکليف‌شده (taklif-e shodah)
round : بخش (bakhsh)
set : گروه (giruha)
set attribute : وسтил‌کردن (vastil-kardan)
slice : لقمه‌ی کوچک (laqmah-e kochak)
sorted : پورووش (pourvoosh)
static method : م Houser û Metode (mohasebe amozesh)
string : سەر (serož)
summation : واری تشکیل (vârı têşkîl)
superset : بەرگری پیه‌ر (bergir pêyaser)
tuple : چوونی چوونی (çûnî çûnî)
type : زمین (zamîn)
variables : واری تنظیم (vârı tenzerim)
zip : ئەستو (alistu)
capitalize : بەج بەرگری (bajê bargirî)
case fold : پەرویستی پەرویست (perwazisti perwazist)
center : ناوچوو (navçû)
count : هەbergerîne (hełbergerîn)
encode : تدیعەول (tediʿawol)
ends with : بەTRaws (bераws)
expand tabs : پەرویستی تاب‌لر (perwostî tablara)
find : ئەمنی کردووم (emnê kurdûwom)
format map : نووسی خارطە (novosî xarâte)
index : ئylâşım (ilâşım)
is alphanumeric : الفانی و مقیاسی (alfanî ve meqyasî)
is alphabetic : الفانی (alfanî)
is ascii : ئەس‌کی‌اسی (es-ki-asi)
is decimal : ديسیمال بوون
is digit : قره‌ی صفحه‌ی عدد
is identifier : پەگەی واردار
is lower : لەوانه‌ی کوچك
is numeric : عددی بوون
is printable : ببینی ئامادەر
is space : ھە雲ی پات
is title : سەردانی واردار
is uppercase : بثی بوون
join : خەاتر كردن
left justify : "Left justify" could be replaced with "align text to the left" or "format text alignment left".
lower : "Lower" could be replaced with "reduce" or "decrease".
left strip : "Left strip" could be replaced with "remove unnecessary characters from the left side of a string" or "trim excess characters from the left of a string".
make translation : "Make translation" could be replaced with "translate text from one language to another" or "interpret text from a different language".
partition : "Partition" could be replaced with "split a string into multiple parts" or "separate a string into sections".
replace : "Replace" could be replaced with "exchange one value for another" or "substitute a new value for an old one".
reverse find : "Reverse find" could be replaced with "locate a specific character or pattern in a string and return its position" or "search for a particular element in a string and retrieve its index number".
reverse index : "Reverse index" could be replaced with "index of a specific character or pattern in a string" or "position of a particular element in a string".
right justify : "Right justify" could be replaced with "align text to the right" or "format text alignment right".
right partition : "Right partition" could be replaced with "split a string into multiple parts using a specified separator" or "separate a string into sections using a designated delimiter".
right split : وونەكاری دوست (roonakari dosut)
right strip : په‌روازی دوست (perwazî dosut)
split : بل (böl)
split lines : خطوط بل (khetoot böl)
starts with : بەشک ئەدرا (beshêk edra)
strip : په‌رواز (perwaz)
swap case : گر Fern (gar fern)
title : عنوان (anvan)
translate : ترجمە (tarjama)
uppercase : فرنگی باوە (farngey bzhavâ)
zero fill : پورستەی نول (porsit-e nol)
append : پگری (pragiri)
clear : واکردن (wakirden)
copy : کピю (kopya)
extend : پاشەکەوت (pash-e kowt)
insert : بازجویی (bazjuii)
pop : پرستە (perstay)
remove : برچه‌سوزی (brich-e sozi)
reverse : پورستەی عق리 (porsit-e aghli)
sort : پورستەی وار (porsit-e var)
from keys : بەمان
get : کسورەکان
items : بگری
keys : واقعه‌ها
pop item : پ Stefanski
set default : تنظيم پووست
update : پشاوردكردنی
values : نامەولەکان
add : ئاوری
difference : فرق
difference update : پەرویستی دیفرینچ (pêroxistî difrinç)
discard : بازگشت (bâzgashte)
intersection : ئاماده‌ی جو (amadey jûl)
intersection update : ئاماده‌ی جو وەرگر (amadey jûl wargar)
is disjoint : لە عولمەندی ناونی (le aulemandi navni)
is subset : لە شاخصردی ناونی (le shakhsi rafti navni)
is superset : لە کلی ناونی (le kuli navni)
symmetric difference : تفاوت متقاطع (tafawot mataqat)
symmetric difference update : تفاوت متقاطع وەرگر (tafawot mataqat wargar)
union : ئاماده‌ی یەکتی (amadey yekti)
close : بسوت (besto)
detach : پارزی کردن (pâreqêzî kardn)
file number : شماره‌ی فایل (shomareh-e faayil)
flush : پوشانی کردن (pooshiri kardn)
is interactive : می Klausner بە (mî Klausner bە)
read : خو بە (khozh bە)
readable : خو ئەوە (khozh ewê)
read line : خو لین (khozh lien)
read lines : خو لینەوە (khozh lienewê)
seek : گشت بە (gashte bە)
seekable : پانی بەرواستی (pānī bērōwāstī)
tell : بیان کردن (bīān kardan)
truncate : قصدر کردن (qasdar kardan)
writable : بەرواستی برووم (bērōwāstī barūom)
write : بیان کردن (bīān kardan)
write lines : لین ها بیان کردن (līn hā bīān kardan)
and : و (va)
as : -
assert : تاکید کردن (tākīd kardan)
break : شکستن (shikastan)
class : کلاس (Klas)
continue : پشوویت (Pêshwûyat)
define : تعیین کردن (Ta'iin Kardan)
delete : ازگار کردن (Râzgâr Kardan)
else if : ئایلeler وەربوو (Ayil-elér vërbû)
else : ئایل (Ayil)
except : هەموو بەرگر (Hemûwo berger)
False : فALSE (Falise)
finally : دوای خواب (Dowai Xolbud)
for : لە (Lê)
from : ووبەر (roh-o-ber)
global : گلوبال (gol-u-bahl)
if : ئایا (ai-a)
import : ئىمپورت (im-po-rt)
in : دەست (des-t)
is : ئەست (es-t)
lambda : لامبدا (lam-ba-da)
None : هیچ (hey-ch)
non-local : نون-لوکل (noon-lok-al)
not : نه‌ (ne)
or : یا (ya)
pass : بەستن (bestan)
raise exception : خطای وارد کردن (khetay warad kardn)
return : پاش كردن (pash kardn)
True : حقیقی (haqiqi)
try : آزمايش كردن (azmayesh kardn)
while : ئەولeler (awoller)
with : دەرگان (dergan)
yield : پاش كردن (pash kardn)
Arithmetic Error : خطای ریاضی (khetay riyazi)
Assertion Error : ئای خطا (Ali Khata)
Attribute Error : وەرگی خطا (Vargi Khata)
Exception : توانای خطا (Tawana Khata)
End Of File Error : بەشکی پەرویستە (Beshaki Parvaz)
Floating Point Error : خطای نقطه‌нишی (Khata-e Neqta-nish)
Generator Exit : دوورت چالاکی (Dowurt Chalaqi)
Import Error : وەرگی باز خطا (Vargi Baz Khata)
Indentation Error : خطای تولید (Khata-e Tolid)
Index Error : خطای نمایش (Khata-e Namayash)
Key Error : خطای گوانی (Khata-e Gavanii)
Keyboard Interrupt : خوردنی کەلوارە (Khoordni Kelawar)
Lookup Error : خطای استعلام (Khataei Estelam)
Memory Error : خطای می (Khataei Mowli)
Name Error : خطای نام (Khataei Nama)
Not Implemented Error : خطای پایگاهش (Khataei Pâyegahsh)
OS Error : خطای سیستم عامل (Khataei Sistem Amel)
Overflow Error : خطای بی انتظار (Khataei Bi Intezâr)
Reference Error : خطای مجاز (Khataei Majaz)
Runtime Error : خطای زمان اجرا (Khataei Zaman Ejra)
Stop Iteration : خطای تکامل برچسبه (Khataei Takamol Bar Chamseh)
Syntax Error : Û navçeya sintaksî (یانوم سەنتەكسی)
Tab Error : Û navçeya tabû (یانوم تابو)
System Error : Û navçeya sistêmê (یانوم سیستم)
System Exit : Û navçeya sistêmê xırabonî (یانوم سیستم خیربنی)
Type Error : Û navçeya tipe (یانوم تیپ)
Unbound Local Error : Û navçeya lokal û nun (یانوم لوکال و نون)
Unicode Error : Û navçeya YUnicode (یانوم یونیکود)
Unicode Encode Error : Û navçeya YUnicode encode (یانوم یونیکود ئەنکود)
Unicode Decode Error : Û navçeya YUnicode decode (یانوم یونیکود که‌وە)
Unicode Translate Error : Û navçeya YUnicode translate (یانوم یونیکود ترجمه‌وە)
Value Error : This term refers to an error that occurs when a program attempts to perform an operation with a value that is not valid or appropriate for that operation. In other words, it's when the input data doesn't meet the expected format or criteria.
Zero Division Error : This term refers to an error that occurs when a program divides a number by zero. Dividing by zero is not allowed in mathematics, and it causes an error in computer programs as well.
